Date,Category,RefNo,Date,Withdrawal,Deposit,Balance
,,,,,,
1/1/2023,Rent,3.00E+11,1/1/2023,3950,0,1837.23
3/1/2023,Misc,3.00E+11,3/1/2023,105,0,1732.23
3/1/2023,Misc,3.37E+11,3/1/2023,0,55,1787.23
3/1/2023,Food,3.00E+11,3/1/2023,56,0,1731.23
3/1/2023,Misc,3.37E+11,3/1/2023,1,0,1730.23
3/1/2023,Food,3.00E+11,3/1/2023,30,0,1700.23
4/1/2023,Misc,3.00E+11,4/1/2023,500,0,1200.23
4/1/2023,Misc,3.00E+11,4/1/2023,1,0,1199.23
4/1/2023,Misc,3.00E+11,4/1/2023,500,0,699.23
10/1/2023,Food,3.01E+11,10/1/2023,28,0,671.23
10/1/2023,Misc,3.01E+11,10/1/2023,149,0,522.23
10/1/2023,Food,3.01E+11,10/1/2023,10,0,512.23
10/1/2023,Misc,3.38E+11,10/1/2023,0,1289,1801.23
10/1/2023,Food,3.01E+11,10/1/2023,51,0,1750.23
10/1/2023,Misc,3.38E+11,10/1/2023,110,0,1640.23
10/1/2023,Food,3.38E+11,10/1/2023,40,0,1600.23
10/1/2023,Food,3.01E+11,10/1/2023,20,0,1580.23
10/1/2023,Food,3.38E+11,10/1/2023,131.5,0,1448.73
10/1/2023,Food,3.38E+11,11/1/2023,27,0,1421.73
11/1/2023,Food,3.01E+11,11/1/2023,50,0,1371.73
11/1/2023,Food,3.38E+11,11/1/2023,33,0,1338.73
11/1/2023,Misc,3.38E+11,11/1/2023,0,33,1371.73
11/1/2023,Food,3.01E+11,11/1/2023,33,0,1338.73
11/1/2023,Misc,3.01E+11,11/1/2023,0,33,1371.73
11/1/2023,Food,3.01E+11,11/1/2023,33,0,1338.73
11/1/2023,Food,3.38E+11,11/1/2023,60,0,1278.73
11/1/2023,Food,3.38E+11,11/1/2023,30,0,1248.73
11/1/2023,Misc,3.38E+11,11/1/2023,305,0,943.73
11/1/2023,Food,3.38E+11,11/1/2023,50,0,893.73
11/1/2023,Food,3.01E+11,11/1/2023,20,0,873.73
12/1/2023,Food,3.38E+11,12/1/2023,57,0,816.73
12/1/2023,Food,3.01E+11,12/1/2023,33,0,783.73
12/1/2023,Food,3.38E+11,12/1/2023,10,0,773.73
12/1/2023,Food,3.01E+11,12/1/2023,35,0,738.73
12/1/2023,Food,3.01E+11,12/1/2023,60,0,678.73
12/1/2023,Food,3.38E+11,12/1/2023,30,0,648.73
12/1/2023,Food,3.01E+11,12/1/2023,20,0,628.73
13/01/23,Food,3.38E+11,13/01/23,57,0,571.73
13/01/23,Food,3.01E+11,13/01/23,60,0,511.73
13/01/23,Misc,3.38E+11,13/01/23,480,0,31.73
13/01/23,Food,3.38E+11,13/01/23,12,0,19.73
13/01/23,Misc,3.38E+11,13/01/23,0,2000,2019.73
13/01/23,Misc,3.38E+11,13/01/23,0,120,2139.73
13/01/23,Food,3.01E+11,13/01/23,50,0,2089.73
13/01/23,Misc,3.01E+11,13/01/23,0,200,2289.73
13/01/23,Food,3.38E+11,13/01/23,15,0,2274.73
14/01/23,Food,3.01E+11,14/01/23,40,0,2234.73
14/01/23,Food,3.38E+11,14/01/23,30,0,2204.73
14/01/23,Food,3.01E+11,14/01/23,173.75,0,2030.98
14/01/23,Misc,3.38E+11,14/01/23,0,25,2055.98
14/01/23,Food,3.38E+11,14/01/23,50,0,2005.98
14/01/23,Food,3.38E+11,14/01/23,20,0,1985.98
14/01/23,Misc,3.38E+11,14/01/23,0,10,1995.98
14/01/23,Food,3.38E+11,14/01/23,30,0,1965.98
15/01/23,Misc,3.38E+11,15/01/23,110,0,1855.98
15/01/23,Food,3.02E+11,15/01/23,35,0,1820.98
15/01/23,Misc,3.38E+11,15/01/23,200,0,1620.98
15/01/23,Food,3.38E+11,15/01/23,30,0,1590.98
15/01/23,Food,3.38E+11,15/01/23,40,0,1550.98
15/01/23,Food,3.38E+11,15/01/23,155.24,0,1395.74
15/01/23,Food,3.38E+11,15/01/23,25,0,1370.74
16/01/23,Food,3.02E+11,16/01/23,12,0,1358.74
16/01/23,Food,3.02E+11,16/01/23,33,0,1325.74
16/01/23,Food,3.38E+11,16/01/23,29,0,1296.74
16/01/23,Food,3.38E+11,16/01/23,50,0,1246.74
16/01/23,Food,3.38E+11,16/01/23,60,0,1186.74
16/01/23,Food,3.38E+11,16/01/23,32,0,1154.74
16/01/23,Food,3.38E+11,16/01/23,20,0,1134.74
17/01/23,Food,3.02E+11,17/01/23,37,0,1097.74
17/01/23,Misc,3.02E+11,17/01/23,272,0,825.74
17/01/23,Food,3.38E+11,17/01/23,70,0,755.74
17/01/23,Food,3.38E+11,17/01/23,30,0,725.74
17/01/23,Food,3.02E+11,17/01/23,85,0,640.74
17/01/23,Food,3.38E+11,17/01/23,20,0,620.74
17/01/23,Food,3.38E+11,17/01/23,20,0,600.74
18/01/23,Food,3.38E+11,18/01/23,10,0,590.74
18/01/23,Food,3.02E+11,18/01/23,33,0,557.74
18/01/23,Food,3.38E+11,18/01/23,20,0,537.74
18/01/23,Food,3.38E+11,18/01/23,60,0,477.74
18/01/23,Food,3.38E+11,18/01/23,40,0,437.74
18/01/23,Food,3.38E+11,18/01/23,40,0,397.74
19/01/23,Misc,3.02E+11,19/01/23,0,120,517.74
19/01/23,Misc,3.39E+11,19/01/23,130,0,387.74
19/01/23,Food,3.39E+11,19/01/23,30,0,357.74
19/01/23,Food,3.39E+11,19/01/23,12,0,345.74
19/01/23,Food,3.02E+11,19/01/23,25,0,320.74
19/01/23,Food,3.02E+11,19/01/23,55,0,265.74
20/01/23,Food,3.39E+11,20/01/23,10,0,255.74
20/01/23,Food,3.39E+11,20/01/23,42,0,213.74
20/01/23,Food,3.39E+11,20/01/23,30,0,183.74
20/01/23,Food,3.02E+11,20/01/23,20,0,163.74
20/01/23,Food,3.39E+11,20/01/23,40,0,123.74
20/01/23,Misc,3.39E+11,21/01/23,0,500,623.74
21/01/23,Food,3.02E+11,21/01/23,42,0,581.74
21/01/23,Food,3.02E+11,21/01/23,80,0,501.74
21/01/23,Food,3.02E+11,21/01/23,30,0,471.74
21/01/23,Food,3.39E+11,21/01/23,25,0,446.74
21/01/23,Misc,3.39E+11,21/01/23,200,0,246.74
21/01/23,Food,3.02E+11,21/01/23,30,0,216.74
21/01/23,Misc,3.39E+11,21/01/23,200,0,16.74
22/01/23,Misc,3.02E+11,22/01/23,0,2000,2016.74
22/01/23,Food,3.39E+11,22/01/23,61,0,1955.74
22/01/23,Misc,3.39E+11,22/01/23,115,0,1840.74
22/01/23,Food,3.39E+11,22/01/23,30,0,1810.74
23/01/23,Food,3.02E+11,23/01/23,15,0,1795.74
23/01/23,Food,3.02E+11,23/01/23,33,0,1762.74
23/01/23,Food,3.39E+11,23/01/23,65,0,1697.74
23/01/23,Food,3.39E+11,23/01/23,30,0,1667.74
23/01/23,Food,3.02E+11,23/01/23,70,0,1597.74
23/01/23,Misc,3.39E+11,23/01/23,0,35,1632.74
23/01/23,Food,3.39E+11,23/01/23,30,0,1602.74
24/01/23,Food,3.39E+11,24/01/23,20,0,1582.74
24/01/23,Food,3.39E+11,24/01/23,90,0,1492.74
24/01/23,Food,3.02E+11,24/01/23,75,0,1417.74
24/01/23,Food,3.02E+11,24/01/23,20,0,1397.74
24/01/23,Food,3.39E+11,24/01/23,50,0,1347.74
25/01/23,Food,3.03E+11,25/01/23,28,0,1319.74
25/01/23,Salary,CHASR23023738798,25/01/23,0,34800,36119.74
25/01/23,Food,3.39E+11,25/01/23,65,0,36054.74
25/01/23,Food,3.03E+11,25/01/23,27,0,36027.74
25/01/23,Food,3.03E+11,25/01/23,30,0,35997.74
25/01/23,Misc,3.39E+11,25/01/23,10000,0,25997.74
25/01/23,Misc,3.39E+11,25/01/23,350,0,25647.74
25/01/23,Food,3.39E+11,25/01/23,40,0,25607.74
25/01/23,Misc,3.39E+11,25/01/23,2,0,25605.74
25/01/23,Misc,3.39E+11,25/01/23,135,0,25470.74
26/01/23,Food,3.03E+11,26/01/23,20,0,25450.74
26/01/23,Misc,3.03E+11,26/01/23,120,0,25330.74
26/01/23,Shopping,3.03E+11,26/01/23,1081,0,24249.74
26/01/23,Misc,3.03E+11,26/01/23,5000,0,19249.74
26/01/23,Misc,3.39E+11,26/01/23,299,0,18950.74
26/01/23,Misc,3.39E+11,26/01/23,2000,0,16950.74
26/01/23,Misc,3.03E+11,26/01/23,1000,0,15950.74
26/01/23,Misc,3.39E+11,26/01/23,0,5000,20950.74
26/01/23,Misc,3.39E+11,26/01/23,5000,0,15950.74
26/01/23,Food,3.39E+11,26/01/23,163.28,0,15787.46
27/01/23,Food,3.03E+11,27/01/23,24,0,15763.46
27/01/23,Misc,3.39E+11,27/01/23,288,0,15475.46
27/01/23,Food,3.39E+11,27/01/23,70,0,15405.46
27/01/23,Misc,3.39E+11,27/01/23,0,72,15477.46
27/01/23,Misc,3.03E+11,27/01/23,0,7000,22477.46
27/01/23,Misc,3.03E+11,27/01/23,17500,0,4977.46
27/01/23,Food,3.39E+11,27/01/23,40,0,4937.46
27/01/23,Food,3.39E+11,27/01/23,80,0,4857.46
28/01/23,Food,3.39E+11,28/01/23,40,0,4817.46
28/01/23,Food,3.03E+11,28/01/23,40,0,4777.46
28/01/23,Misc,3.03E+11,28/01/23,1000,0,3777.46
28/01/23,Food,3.39E+11,28/01/23,40,0,3737.46
29/01/23,Food,3.40E+11,29/01/23,20,0,3717.46
29/01/23,Food,3.03E+11,29/01/23,40,0,3677.46
29/01/23,Misc,3.40E+11,29/01/23,149,0,3528.46
29/01/23,Misc,3.03E+11,29/01/23,250,0,3278.46
29/01/23,Misc,3.40E+11,29/01/23,250,0,3028.46
29/01/23,Misc,3.40E+11,29/01/23,500,0,2528.46
29/01/23,Food,3.40E+11,29/01/23,189.05,0,2339.41
29/01/23,Food,3.40E+11,30/01/23,40,0,2299.41
30/01/23,Food,3.03E+11,30/01/23,50,0,2249.41
30/01/23,Food,3.40E+11,30/01/23,85,0,2164.41
30/01/23,Food,3.40E+11,30/01/23,50,0,2114.41
30/01/23,Food,3.40E+11,30/01/23,90,0,2024.41
30/01/23,Food,3.40E+11,30/01/23,20,0,2004.41
31/01/23,Food,3.03E+11,31/01/23,28,0,1976.41
31/01/23,Misc,3.40E+11,31/01/23,125,0,1851.41
31/01/23,Food,3.03E+11,31/01/23,40,0,1811.41
31/01/23,Misc,3.03E+11,31/01/23,0,10000,11811.41
31/01/23,Food,3.40E+11,31/01/23,154.44,0,11656.97
1/2/2023,Food,3.03E+11,1/2/2023,30,0,11626.97
1/2/2023,Food,3.40E+11,1/2/2023,20,0,11606.97
1/2/2023,Food,3.03E+11,1/2/2023,80,0,11526.97
2/2/2023,Rent,3.03E+11,2/2/2023,5776,0,5750.97
2/2/2023,Food,3.40E+11,2/2/2023,20,0,5730.97
2/2/2023,Food,3.03E+11,2/2/2023,144.87,0,5586.1
2/2/2023,Food,3.40E+11,2/2/2023,40,0,5546.1
2/2/2023,Food,3.40E+11,2/2/2023,30,0,5516.1
2/2/2023,Misc,3.40E+11,2/2/2023,170,0,5346.1
3/2/2023,Food,3.03E+11,3/2/2023,28,0,5318.1
3/2/2023,Food,3.40E+11,3/2/2023,50,0,5268.1
3/2/2023,Misc,3.03E+11,3/2/2023,500,0,4768.1
3/2/2023,Misc,3.03E+11,3/2/2023,0,500,5268.1
3/2/2023,Food,3.40E+11,3/2/2023,17,0,5251.1
3/2/2023,Misc,3.40E+11,3/2/2023,190,0,5061.1
3/2/2023,Food,3.40E+11,3/2/2023,40,0,5021.1
4/2/2023,Misc,3.04E+11,4/2/2023,200,0,4821.1
4/2/2023,Food,3.40E+11,4/2/2023,30,0,4791.1
4/2/2023,Food,3.04E+11,4/2/2023,40,0,4751.1
4/2/2023,Misc,3.40E+11,4/2/2023,0,152,4903.1
4/2/2023,Misc,3.40E+11,4/2/2023,140,0,4763.1
4/2/2023,Food,3.40E+11,4/2/2023,30,0,4733.1
4/2/2023,Food,3.40E+11,4/2/2023,40,0,4693.1
5/2/2023,Food,3.40E+11,5/2/2023,40,0,4653.1
5/2/2023,Misc,3.40E+11,5/2/2023,180,0,4473.1
6/2/2023,Food,3.40E+11,6/2/2023,80,0,4393.1
6/2/2023,Food,3.40E+11,6/2/2023,100,0,4293.1
6/2/2023,Food,3.04E+11,6/2/2023,20,0,4273.1
6/2/2023,Misc,3.04E+11,6/2/2023,700,0,3573.1
6/2/2023,Food,3.40E+11,6/2/2023,20,0,3553.1
7/2/2023,Food,3.40E+11,7/2/2023,65,0,3488.1
7/2/2023,Food,3.04E+11,7/2/2023,36,0,3452.1
7/2/2023,Food,3.40E+11,7/2/2023,40,0,3412.1
7/2/2023,Food,3.40E+11,7/2/2023,10,0,3402.1
8/2/2023,Food,3.41E+11,8/2/2023,150.28,0,3251.82
8/2/2023,Food,3.04E+11,8/2/2023,20,0,3231.82
8/2/2023,Misc,3.04E+11,8/2/2023,500,0,2731.82
8/2/2023,Food,3.41E+11,8/2/2023,30,0,2701.82
9/2/2023,Food,3.04E+11,9/2/2023,33,0,2668.82
9/2/2023,Food,3.41E+11,9/2/2023,30,0,2638.82
9/2/2023,Shopping,3.04E+11,9/2/2023,474,0,2164.82
9/2/2023,Food,3.41E+11,9/2/2023,32,0,2132.82
9/2/2023,Food,3.41E+11,9/2/2023,20,0,2112.82
10/2/2023,Food,3.04E+11,10/2/2023,40,0,2072.82
10/2/2023,Food,3.41E+11,10/2/2023,54,0,2018.82
10/2/2023,Food,3.41E+11,10/2/2023,51,0,1967.82
10/2/2023,Food,3.04E+11,10/2/2023,60,0,1907.82
10/2/2023,Food,3.04E+11,10/2/2023,39,0,1868.82
10/2/2023,Food,3.41E+11,10/2/2023,30,0,1838.82
10/2/2023,Food,3.41E+11,10/2/2023,52,0,1786.82
11/2/2023,Shopping,3.04E+11,11/2/2023,0,249,2035.82
11/2/2023,Shopping,3.04E+11,11/2/2023,0,225,2260.82
11/2/2023,Shopping,3.04E+11,11/2/2023,261,0,1999.82
11/2/2023,Food,3.04E+11,11/2/2023,32,0,1967.82
11/2/2023,Food,3.04E+11,11/2/2023,150.28,0,1817.54
11/2/2023,Food,3.41E+11,11/2/2023,60,0,1757.54
11/2/2023,Misc,3.04E+11,11/2/2023,0,500,2257.54
12/2/2023,Misc,3.41E+11,12/2/2023,330,0,1927.54
12/2/2023,Food,3.41E+11,12/2/2023,44,0,1883.54
12/2/2023,Food,3.41E+11,12/2/2023,100,0,1783.54
12/2/2023,Misc,3.04E+11,12/2/2023,500,0,1283.54
12/2/2023,Misc,3.04E+11,12/2/2023,117,0,1166.54
12/2/2023,Food,3.04E+11,12/2/2023,25,0,1141.54
12/2/2023,Food,3.04E+11,12/2/2023,30,0,1111.54
13/02/23,Food,3.04E+11,13/02/23,40,0,1071.54
13/02/23,Food,3.41E+11,13/02/23,173.7,0,897.84
13/02/23,Food,3.04E+11,13/02/23,67,0,830.84
13/02/23,Food,3.41E+11,13/02/23,40,0,790.84
14/02/23,Food,3.41E+11,14/02/23,40,0,750.84
14/02/23,Food,3.05E+11,14/02/23,242.45,0,508.39
14/02/23,Food,3.05E+11,14/02/23,60,0,448.39
15/02/23,Food,3.05E+11,15/02/23,40,0,408.39
15/02/23,Food,3.05E+11,15/02/23,148,0,260.39
15/02/23,Misc,3.05E+11,15/02/23,130,0,130.39
16/02/23,Food,3.05E+11,16/02/23,30,0,100.39
16/02/23,Food,3.41E+11,16/02/23,40,0,60.39
16/02/23,Misc,3.05E+11,16/02/23,0,80,140.39
16/02/23,Food,3.05E+11,16/02/23,100,0,40.39
16/02/23,Misc,3.41E+11,16/02/23,0,1500,1540.39
17/02/23,Misc,3.05E+11,17/02/23,5,0,1535.39
17/02/23,Food,3.41E+11,17/02/23,20,0,1515.39
17/02/23,Food,3.05E+11,17/02/23,30,0,1485.39
17/02/23,Food,3.41E+11,17/02/23,65,0,1420.39
17/02/23,Food,3.41E+11,17/02/23,30,0,1390.39
17/02/23,Food,3.41E+11,17/02/23,70,0,1320.39
17/02/23,Food,3.05E+11,17/02/23,50,0,1270.39
17/02/23,Misc,3.05E+11,17/02/23,475,0,795.39
17/02/23,Food,3.41E+11,17/02/23,30,0,765.39
18/02/23,Food,3.42E+11,18/02/23,10,0,755.39
18/02/23,Food,3.05E+11,18/02/23,60,0,695.39
18/02/23,Food,3.42E+11,18/02/23,20,0,675.39
18/02/23,Food,3.42E+11,18/02/23,70,0,605.39
18/02/23,Food,3.42E+11,18/02/23,20,0,585.39
19/02/23,Misc,3.05E+11,19/02/23,150.5,0,434.89
19/02/23,Misc,3.05E+11,19/02/23,136,0,298.89
19/02/23,Misc,3.42E+11,19/02/23,8,0,290.89
19/02/23,Food,3.05E+11,19/02/23,67,0,223.89
19/02/23,Food,3.05E+11,19/02/23,100,0,123.89
19/02/23,Food,3.42E+11,19/02/23,40,0,83.89
20/02/23,Food,3.42E+11,20/02/23,40,0,43.89
20/02/23,Misc,3.42E+11,20/02/23,0,500,543.89
20/02/23,Food,3.05E+11,20/02/23,65,0,478.89
20/02/23,Food,3.42E+11,20/02/23,20,0,458.89
20/02/23,Food,3.05E+11,20/02/23,45,0,413.89
21/02/23,Food,3.42E+11,21/02/23,33,0,380.89
21/02/23,Food,3.05E+11,21/02/23,40,0,340.89
21/02/23,Food,3.42E+11,21/02/23,30,0,310.89
21/02/23,Food,3.05E+11,21/02/23,50,0,260.89
21/02/23,Food,3.05E+11,21/02/23,35,0,225.89
22/02/23,Misc,3.42E+11,22/02/23,0,6000,6225.89
22/02/23,Misc,3.05E+11,22/02/23,5500,0,725.89
22/02/23,Food,3.42E+11,22/02/23,50,0,675.89
22/02/23,Food,3.42E+11,22/02/23,35,0,640.89
22/02/23,Food,3.05E+11,22/02/23,50,0,590.89
22/02/23,Food,3.05E+11,22/02/23,42,0,548.89
23/02/23,Food,3.42E+11,23/02/23,20,0,528.89
23/02/23,Food,3.05E+11,23/02/23,40,0,488.89
23/02/23,Misc,3.42E+11,23/02/23,400,0,88.89
23/02/23,Food,3.05E+11,23/02/23,30,0,58.89
23/02/23,Food,3.05E+11,23/02/23,40,0,18.89
24/02/23,Salary,CHASS23053481613,24/02/23,0,34800,34818.89
24/02/23,Food,3.06E+11,24/02/23,70,0,34748.89
24/02/23,Food,3.06E+11,24/02/23,40,0,34708.89
24/02/23,Misc,3.06E+11,24/02/23,799,0,33909.89
24/02/23,Misc,3.42E+11,24/02/23,180,0,33729.89
24/02/23,Food,3.42E+11,24/02/23,75,0,33654.89
24/02/23,Misc,3.06E+11,24/02/23,642,0,33012.89
24/02/23,Food,3.42E+11,24/02/23,12,0,33000.89
25/02/23,Misc,3.42E+11,25/02/23,10000,0,23000.89
25/02/23,Misc,3.06E+11,25/02/23,140,0,22860.89
25/02/23,Food,3.42E+11,25/02/23,20,0,22840.89
25/02/23,Food,3.42E+11,25/02/23,10,0,22830.89
25/02/23,Food,3.42E+11,25/02/23,40,0,22790.89
25/02/23,Misc,3.42E+11,25/02/23,500,0,22290.89
25/02/23,Food,3.42E+11,25/02/23,25,0,22265.89
25/02/23,Misc,3.42E+11,25/02/23,0,2000,24265.89
25/02/23,Misc,3.42E+11,25/02/23,4003,0,20262.89
26/02/23,Food,3.06E+11,26/02/23,34,0,20228.89
26/02/23,Food,3.06E+11,26/02/23,22,0,20206.89
26/02/23,Food,3.06E+11,26/02/23,10,0,20196.89
26/02/23,Misc,3.06E+11,26/02/23,0,3400,23596.89
26/02/23,Food,3.42E+11,26/02/23,20,0,23576.89
26/02/23,Misc,3.06E+11,26/02/23,4000,0,19576.89
26/02/23,Shopping,3.06E+11,26/02/23,251,0,19325.89
26/02/23,Misc,3.42E+11,26/02/23,1000,0,18325.89
26/02/23,Shopping,3.42E+11,26/02/23,429,0,17896.89
26/02/23,Misc,3.06E+11,26/02/23,2000,0,15896.89
26/02/23,Misc,3.06E+11,26/02/23,302,0,15594.89
27/02/23,Shopping,3.06E+11,27/02/23,299,0,15295.89
27/02/23,Food,3.06E+11,27/02/23,20,0,15275.89
27/02/23,Food,3.42E+11,27/02/23,40,0,15235.89
27/02/23,Misc,3.06E+11,27/02/23,570,0,14665.89
27/02/23,Misc,3.06E+11,27/02/23,306,0,14359.89
27/02/23,Food,3.06E+11,27/02/23,100,0,14259.89
27/02/23,Misc,3.06E+11,27/02/23,1315,0,12944.89
27/02/23,Food,3.42E+11,27/02/23,25,0,12919.89
27/02/23,Food,3.42E+11,27/02/23,20,0,12899.89
28/02/23,Food,3.06E+11,28/02/23,68,0,12831.89
28/02/23,Food,3.43E+11,28/02/23,65,0,12766.89
28/02/23,Food,3.43E+11,28/02/23,40,0,12726.89
28/02/23,Misc,3.06E+11,28/02/23,830,0,11896.89
1/3/2023,Food,3.43E+11,1/3/2023,60,0,11836.89
1/3/2023,Food,3.43E+11,1/3/2023,30,0,11806.89
2/3/2023,Food,3.43E+11,2/3/2023,28,0,11778.89
2/3/2023,Misc,3.43E+11,2/3/2023,110,0,11668.89
2/3/2023,Food,3.43E+11,2/3/2023,50,0,11618.89
2/3/2023,Misc,3.43E+11,2/3/2023,500,0,11118.89
2/3/2023,Food,3.43E+11,2/3/2023,30,0,11088.89
3/3/2023,Food,3.43E+11,3/3/2023,33,0,11055.89
3/3/2023,Misc,3.43E+11,3/3/2023,240,0,10815.89
3/3/2023,Food,3.43E+11,3/3/2023,60,0,10755.89
3/3/2023,Rent,3.06E+11,3/3/2023,6490,0,4265.89
3/3/2023,Food,3.06E+11,3/3/2023,35,0,4230.89
4/3/2023,Misc,3.06E+11,4/3/2023,105,0,4125.89
4/3/2023,Food,3.06E+11,4/3/2023,10,0,4115.89
4/3/2023,Food,3.43E+11,4/3/2023,30,0,4085.89
4/3/2023,Food,3.43E+11,4/3/2023,25,0,4060.89
4/3/2023,Misc,3.06E+11,4/3/2023,200,0,3860.89
4/3/2023,Misc,3.43E+11,4/3/2023,420,0,3440.89
4/3/2023,Food,3.43E+11,4/3/2023,40,0,3400.89
5/3/2023,Food,3.06E+11,5/3/2023,30,0,3370.89
5/3/2023,Food,3.43E+11,5/3/2023,100,0,3270.89
5/3/2023,Misc,3.06E+11,5/3/2023,300,0,2970.89
5/3/2023,Food,3.06E+11,5/3/2023,40,0,2930.89
5/3/2023,Misc,3.06E+11,5/3/2023,500,0,2430.89
5/3/2023,Food,3.06E+11,5/3/2023,20,0,2410.89
6/3/2023,Misc,3.43E+11,6/3/2023,0,131,2541.89
6/3/2023,Food,3.43E+11,6/3/2023,50,0,2491.89
6/3/2023,Food,3.07E+11,6/3/2023,37,0,2454.89
6/3/2023,Food,3.43E+11,6/3/2023,40,0,2414.89
7/3/2023,Food,3.43E+11,7/3/2023,72,0,2342.89
7/3/2023,Food,3.43E+11,7/3/2023,50,0,2292.89
7/3/2023,Food,3.07E+11,7/3/2023,25,0,2267.89
7/3/2023,Food,3.43E+11,7/3/2023,35,0,2232.89
8/3/2023,Misc,3.07E+11,8/3/2023,7,0,2225.89
8/3/2023,Food,3.07E+11,8/3/2023,30,0,2195.89
8/3/2023,Food,3.07E+11,8/3/2023,75,0,2120.89
8/3/2023,Misc,3.07E+11,8/3/2023,150.5,0,1970.39
8/3/2023,Food,3.07E+11,8/3/2023,40,0,1930.39
9/3/2023,Food,3.07E+11,9/3/2023,99,0,1831.39
9/3/2023,Food,3.07E+11,9/3/2023,34,0,1797.39
9/3/2023,Misc,3.43E+11,9/3/2023,205,0,1592.39
9/3/2023,Food,3.43E+11,9/3/2023,60,0,1532.39
9/3/2023,Food,3.07E+11,9/3/2023,79,0,1453.39
9/3/2023,Food,3.43E+11,9/3/2023,160.87,0,1292.52
10/3/2023,Food,3.07E+11,10/3/2023,50,0,1242.52
10/3/2023,Food,3.44E+11,10/3/2023,50,0,1192.52
10/3/2023,Food,3.07E+11,10/3/2023,214.96,0,977.56
10/3/2023,Misc,3.07E+11,10/3/2023,0,300,1277.56
10/3/2023,Food,3.07E+11,10/3/2023,70,0,1207.56
11/3/2023,Food,3.07E+11,11/3/2023,62,0,1145.56
11/3/2023,Misc,3.44E+11,11/3/2023,0,210,1355.56
11/3/2023,Misc,3.07E+11,11/3/2023,500,0,855.56
11/3/2023,Food,3.44E+11,11/3/2023,60,0,795.56
11/3/2023,Food,3.44E+11,11/3/2023,25.3,0,770.26
12/3/2023,Misc,3.07E+11,12/3/2023,300,0,470.26
12/3/2023,Food,3.07E+11,12/3/2023,30,0,440.26
12/3/2023,Food,3.07E+11,12/3/2023,40,0,400.26
12/3/2023,Food,3.44E+11,12/3/2023,54,0,346.26
12/3/2023,Food,3.44E+11,12/3/2023,40,0,306.26
13/03/23,Food,3.07E+11,13/03/23,20,0,286.26
13/03/23,Food,3.07E+11,13/03/23,47,0,239.26
13/03/23,Food,3.44E+11,13/03/23,65,0,174.26
13/03/23,Food,3.07E+11,13/03/23,50,0,124.26
13/03/23,Food,3.07E+11,13/03/23,85,0,39.26
14/03/23,Misc,3.07E+11,14/03/23,0,1000,1039.26
14/03/23,Food,3.44E+11,14/03/23,79,0,960.26
14/03/23,Food,3.07E+11,14/03/23,30,0,930.26
14/03/23,Food,3.07E+11,14/03/23,55,0,875.26
15/03/23,Food,3.44E+11,15/03/23,33,0,842.26
15/03/23,Food,3.44E+11,15/03/23,50,0,792.26
15/03/23,Food,3.07E+11,16/03/23,55,0,737.26
16/03/23,Misc,3.08E+11,16/03/23,136,0,601.26
16/03/23,Food,3.44E+11,16/03/23,50,0,551.26
16/03/23,Food,3.44E+11,16/03/23,35,0,516.26
16/03/23,Food,3.08E+11,16/03/23,30,0,486.26
16/03/23,Food,3.08E+11,16/03/23,65,0,421.26
17/03/23,Food,3.08E+11,17/03/23,50,0,371.26
17/03/23,Food,3.08E+11,17/03/23,30,0,341.26
17/03/23,Food,3.08E+11,17/03/23,30,0,311.26
17/03/23,Food,3.08E+11,17/03/23,75,0,236.26
18/03/23,Food,3.44E+11,18/03/23,30,0,206.26
18/03/23,Food,3.08E+11,18/03/23,35,0,171.26
18/03/23,Food,3.08E+11,18/03/23,30,0,141.26
19/03/23,Food,3.44E+11,19/03/23,61,0,80.26
19/03/23,Food,3.08E+11,19/03/23,30,0,50.26
19/03/23,Food,3.08E+11,19/03/23,10,0,40.26
20/03/23,Food,3.08E+11,20/03/23,30,0,10.26
21/03/23,Misc,3.08E+11,21/03/23,0,60,70.26
21/03/23,Misc,3.45E+11,21/03/23,0,40,110.26
22/03/23,Misc,3.45E+11,22/03/23,2,0,108.26
22/03/23,Food,3.45E+11,22/03/23,42,0,66.26
24/03/23,Salary,CHAST23081324539,24/03/23,0,34800,34866.26
24/03/23,Misc,3.45E+11,24/03/23,11000,0,23866.26
24/03/23,Misc,3.45E+11,24/03/23,1926.72,0,21939.54
24/03/23,Shopping,3.08E+11,24/03/23,670,0,21269.54
24/03/23,Misc,3.45E+11,24/03/23,1479,0,19790.54
24/03/23,Food,3.08E+11,24/03/23,81,0,19709.54
24/03/23,Food,3.45E+11,24/03/23,48,0,19661.54
24/03/23,Food,3.45E+11,24/03/23,72,0,19589.54
24/03/23,Food,3.08E+11,24/03/23,42,0,19547.54
24/03/23,Misc,3.08E+11,24/03/23,5000,0,14547.54
24/03/23,Misc,3.08E+11,24/03/23,660,0,13887.54
24/03/23,Food,3.45E+11,24/03/23,66,0,13821.54
24/03/23,Food,3.45E+11,24/03/23,30,0,13791.54
24/03/23,Food,3.45E+11,24/03/23,100,0,13691.54
24/03/23,Misc,3.08E+11,24/03/23,1500,0,12191.54
24/03/23,Food,3.08E+11,24/03/23,10,0,12181.54
25/03/23,Food,3.08E+11,25/03/23,76,0,12105.54
25/03/23,Food,3.45E+11,25/03/23,22,0,12083.54
25/03/23,Food,3.45E+11,25/03/23,87,0,11996.54
25/03/23,Misc,3.08E+11,25/03/23,470,0,11526.54
25/03/23,Misc,3.08E+11,26/03/23,2826,0,8700.54
26/03/23,Food,3.09E+11,26/03/23,32,0,8668.54
26/03/23,Food,3.09E+11,26/03/23,72,0,8596.54
26/03/23,Food,3.45E+11,26/03/23,10,0,8586.54
26/03/23,Misc,3.45E+11,26/03/23,0,421,9007.54
26/03/23,Misc,3.09E+11,26/03/23,150,0,8857.54
26/03/23,Food,3.09E+11,26/03/23,80,0,8777.54
26/03/23,Food,3.45E+11,26/03/23,41,0,8736.54
26/03/23,Misc,3.45E+11,26/03/23,0,1000,9736.54
26/03/23,Misc,3.09E+11,26/03/23,0,802,10538.54
26/03/23,Misc,3.09E+11,26/03/23,0,927,11465.54
26/03/23,Food,3.09E+11,26/03/23,10,0,11455.54
27/03/23,Shopping,3.45E+11,27/03/23,254,0,11201.54
27/03/23,Misc,3.45E+11,27/03/23,0,5130,16331.54
27/03/23,Food,3.45E+11,27/03/23,40,0,16291.54
28/03/23,Misc,3.45E+11,28/03/23,210.9,0,16080.64
28/03/23,Misc,3.45E+11,28/03/23,144,0,15936.64
28/03/23,Misc,3.09E+11,28/03/23,1000,0,14936.64
28/03/23,Food,3.45E+11,28/03/23,52,0,14884.64
28/03/23,Food,3.45E+11,28/03/23,30,0,14854.64
28/03/23,Food,3.45E+11,28/03/23,42,0,14812.64
29/03/23,Food,3.45E+11,29/03/23,22,0,14790.64
29/03/23,Food,3.45E+11,29/03/23,32,0,14758.64
29/03/23,Misc,3.45E+11,29/03/23,353,0,14405.64
29/03/23,Food,3.45E+11,29/03/23,42,0,14363.64
29/03/23,Food,3.09E+11,29/03/23,15.35,0,14348.29
29/03/23,Misc,3.09E+11,29/03/23,220,0,14128.29
29/03/23,Food,3.45E+11,29/03/23,20,0,14108.29
30/03/23,Food,3.46E+11,30/03/23,90,0,14018.29
30/03/23,Misc,3.46E+11,30/03/23,150,0,13868.29
30/03/23,Food,3.46E+11,30/03/23,42,0,13826.29
30/03/23,Food,3.46E+11,30/03/23,15.35,0,13810.94
30/03/23,Misc,3.46E+11,30/03/23,354,0,13456.94
30/03/23,Food,3.46E+11,30/03/23,55,0,13401.94
30/03/23,Food,3.09E+11,30/03/23,75,0,13326.94
30/03/23,Food,3.09E+11,30/03/23,50,0,13276.94
31/03/23,Food,3.46E+11,31/03/23,47,0,13229.94
31/03/23,Food,3.46E+11,31/03/23,40,0,13189.94
31/03/23,Misc,3.46E+11,31/03/23,115,0,13074.94
31/03/23,Food,3.46E+11,31/03/23,22,0,13052.94
1/4/2023,Rent,3.09E+11,1/4/2023,6356,0,6696.94
1/4/2023,Misc,0,31/03/23,0,32,6728.94
1/4/2023,Food,3.09E+11,1/4/2023,42,0,6686.94
1/4/2023,Food,3.09E+11,1/4/2023,267.15,0,6419.79
1/4/2023,Misc,3.09E+11,1/4/2023,550,0,5869.79
1/4/2023,Food,3.46E+11,1/4/2023,42,0,5827.79
2/4/2023,Food,3.46E+11,2/4/2023,32,0,5795.79
2/4/2023,Misc,3.09E+11,2/4/2023,150,0,5645.79
2/4/2023,Misc,3.46E+11,2/4/2023,1200,0,4445.79
3/4/2023,Misc,3.46E+11,3/4/2023,0,1200,5645.79
3/4/2023,Food,3.46E+11,3/4/2023,82,0,5563.79
3/4/2023,Food,3.09E+11,3/4/2023,85,0,5478.79
3/4/2023,Misc,3.09E+11,3/4/2023,295,0,5183.79
3/4/2023,Food,3.09E+11,3/4/2023,20,0,5163.79
3/4/2023,Food,3.46E+11,3/4/2023,10,0,5153.79
4/4/2023,Misc,3.46E+11,4/4/2023,150,0,5003.79
4/4/2023,Food,3.46E+11,4/4/2023,52,0,4951.79
4/4/2023,Misc,3.09E+11,4/4/2023,1000,0,3951.79
4/4/2023,Misc,3.46E+11,4/4/2023,144,0,3807.79
4/4/2023,Food,3.09E+11,4/4/2023,65,0,3742.79
4/4/2023,Shopping,3.46E+11,4/4/2023,54,0,3688.79
5/4/2023,Shopping,3.10E+11,5/4/2023,0,54,3742.79
5/4/2023,Misc,3.10E+11,5/4/2023,2000,0,1742.79
5/4/2023,Food,3.10E+11,5/4/2023,42,0,1700.79
5/4/2023,Misc,3.10E+11,5/4/2023,300,0,1400.79
5/4/2023,Food,3.10E+11,5/4/2023,90,0,1310.79
6/4/2023,Food,3.10E+11,6/4/2023,30,0,1280.79
6/4/2023,Food,3.10E+11,6/4/2023,20,0,1260.79
6/4/2023,Misc,3.46E+11,6/4/2023,250,0,1010.79
6/4/2023,Misc,3.10E+11,6/4/2023,120,0,890.79
6/4/2023,Food,3.10E+11,6/4/2023,20,0,870.79
7/4/2023,Food,3.10E+11,7/4/2023,55,0,815.79
7/4/2023,Food,3.10E+11,7/4/2023,10,0,805.79
7/4/2023,Food,3.10E+11,7/4/2023,50,0,755.79
7/4/2023,Food,3.46E+11,7/4/2023,32,0,723.79
7/4/2023,Food,3.10E+11,7/4/2023,65,0,658.79
7/4/2023,Food,3.10E+11,7/4/2023,20,0,638.79
7/4/2023,Misc,3.46E+11,7/4/2023,220,0,418.79
7/4/2023,Food,3.46E+11,7/4/2023,51,0,367.79
8/4/2023,Food,3.46E+11,8/4/2023,50,0,317.79
8/4/2023,Misc,3.10E+11,8/4/2023,0,1000,1317.79
8/4/2023,Food,3.46E+11,8/4/2023,70,0,1247.79
8/4/2023,Food,3.10E+11,8/4/2023,208.28,0,1039.51
9/4/2023,Misc,3.47E+11,9/4/2023,310,0,729.51
9/4/2023,Food,3.47E+11,9/4/2023,76,0,653.51
9/4/2023,Food,3.47E+11,9/4/2023,100,0,553.51
9/4/2023,Food,3.47E+11,9/4/2023,20,0,533.51
10/4/2023,Misc,3.47E+11,10/4/2023,138,0,395.51
10/4/2023,Misc,3.10E+11,10/4/2023,0,4000,4395.51
10/4/2023,Misc,3.10E+11,10/4/2023,3000,0,1395.51
10/4/2023,Misc,3.47E+11,10/4/2023,140,0,1255.51
10/4/2023,Food,3.47E+11,10/4/2023,20,0,1235.51
11/4/2023,Food,3.10E+11,11/4/2023,40,0,1195.51
11/4/2023,Food,3.47E+11,11/4/2023,65,0,1130.51
11/4/2023,Misc,3.47E+11,11/4/2023,140,0,990.51
12/4/2023,Food,3.47E+11,12/4/2023,20,0,970.51
12/4/2023,Food,3.47E+11,12/4/2023,46,0,924.51
12/4/2023,Misc,3.10E+11,12/4/2023,0,1000,1924.51
12/4/2023,Misc,3.10E+11,12/4/2023,0,300,2224.51
12/4/2023,Misc,3.47E+11,12/4/2023,185,0,2039.51
12/4/2023,Food,3.47E+11,12/4/2023,80,0,1959.51
13/04/23,Food,3.47E+11,13/04/23,72,0,1887.51
13/04/23,Food,3.10E+11,13/04/23,50,0,1837.51
13/04/23,Food,3.10E+11,13/04/23,25,0,1812.51
13/04/23,Food,3.10E+11,13/04/23,56,0,1756.51
13/04/23,Food,3.47E+11,13/04/23,220.68,0,1535.83
13/04/23,Food,3.47E+11,13/04/23,86,0,1449.83
14/04/23,Food,3.47E+11,14/04/23,65,0,1384.83
14/04/23,Food,3.10E+11,14/04/23,66,0,1318.83
14/04/23,Food,3.47E+11,14/04/23,100,0,1218.83
14/04/23,Misc,3.47E+11,14/04/23,160,0,1058.83
14/04/23,Food,3.47E+11,14/04/23,70,0,988.83
15/04/23,Food,3.11E+11,15/04/23,30,0,958.83
15/04/23,Food,3.11E+11,15/04/23,100,0,858.83
15/04/23,Food,3.47E+11,15/04/23,272.26,0,586.57
15/04/23,Misc,3.47E+11,15/04/23,110,0,476.57
15/04/23,Food,3.47E+11,15/04/23,75,0,401.57
15/04/23,Food,3.47E+11,15/04/23,40,0,361.57
16/04/23,Misc,3.11E+11,16/04/23,9,0,352.57
16/04/23,Misc,3.47E+11,16/04/23,0,500,852.57
16/04/23,Misc,3.47E+11,16/04/23,120,0,732.57
16/04/23,Food,3.47E+11,16/04/23,50,0,682.57
16/04/23,Shopping,3.47E+11,16/04/23,189,0,493.57
16/04/23,Food,3.47E+11,16/04/23,30,0,463.57
16/04/23,Food,3.47E+11,16/04/23,65,0,398.57
16/04/23,Food,3.47E+11,16/04/23,10,0,388.57
16/04/23,Food,3.11E+11,16/04/23,30,0,358.57
16/04/23,Food,3.47E+11,16/04/23,80,0,278.57
16/04/23,Food,3.47E+11,16/04/23,45,0,233.57
17/04/23,Food,3.47E+11,17/04/23,65,0,168.57
17/04/23,Food,3.11E+11,17/04/23,50,0,118.57
17/04/23,Food,3.11E+11,17/04/23,15.3,0,103.27
17/04/23,Food,3.47E+11,17/04/23,30,0,73.27
18/04/23,Food,3.47E+11,18/04/23,20,0,53.27
19/04/23,Food,3.11E+11,19/04/23,40,0,13.27
19/04/23,Misc,3.48E+11,19/04/23,0,35,48.27
20/04/23,Misc,3.11E+11,20/04/23,0,1180,1228.27
20/04/23,Food,3.11E+11,20/04/23,41,0,1187.27
20/04/23,Food,3.11E+11,20/04/23,20,0,1167.27
20/04/23,Food,3.48E+11,20/04/23,41,0,1126.27
20/04/23,Food,3.48E+11,20/04/23,90,0,1036.27
20/04/23,Food,3.48E+11,20/04/23,75,0,961.27
21/04/23,Food,3.11E+11,21/04/23,60,0,901.27
21/04/23,Food,3.48E+11,21/04/23,90,0,811.27
21/04/23,Misc,3.48E+11,21/04/23,130,0,681.27
21/04/23,Food,3.48E+11,21/04/23,231.4,0,449.87
22/04/23,Food,3.11E+11,22/04/23,40,0,409.87
22/04/23,Misc,3.48E+11,22/04/23,120,0,289.87
22/04/23,Food,3.48E+11,22/04/23,50,0,239.87
22/04/23,Food,3.11E+11,22/04/23,25,0,214.87
22/04/23,Food,3.11E+11,22/04/23,20,0,194.87
22/04/23,Food,3.48E+11,22/04/23,50,0,144.87
22/04/23,Food,3.48E+11,22/04/23,90,0,54.87
22/04/23,Food,3.48E+11,22/04/23,35,0,19.87
22/04/23,Food,3.48E+11,22/04/23,10,0,9.87
23/04/23,Misc,3.11E+11,23/04/23,0,1745,1754.87
23/04/23,Misc,3.48E+11,23/04/23,730,0,1024.87
23/04/23,Food,3.48E+11,23/04/23,20,0,1004.87
23/04/23,Food,3.48E+11,23/04/23,65,0,939.87
24/04/23,Food,3.11E+11,24/04/23,40,0,899.87
24/04/23,Food,3.11E+11,24/04/23,20,0,879.87
24/04/23,Food,3.48E+11,24/04/23,20,0,859.87
24/04/23,Food,3.48E+11,24/04/23,78,0,781.87
24/04/23,Misc,3.11E+11,24/04/23,0,539,1320.87
24/04/23,Food,3.48E+11,24/04/23,40,0,1280.87
24/04/23,Food,3.48E+11,24/04/23,85,0,1195.87
24/04/23,Food,3.11E+11,24/04/23,15.3,0,1180.57
24/04/23,Food,3.48E+11,24/04/23,30,0,1150.57
24/04/23,Food,3.48E+11,24/04/23,342.4,0,808.17
24/04/23,Food,3.48E+11,24/04/23,0,292.4,1100.57
24/04/23,Food,3.48E+11,24/04/23,205.45,0,895.12
25/04/23,Food,3.12E+11,25/04/23,29.3,0,865.82
25/04/23,Salary,CHAST23111858452,25/04/23,0,34800,35665.82
25/04/23,Misc,3.12E+11,25/04/23,10000,0,25665.82
25/04/23,Misc,3.12E+11,25/04/23,999,0,24666.82
25/04/23,Misc,3.48E+11,25/04/23,110,0,24556.82
25/04/23,Food,3.48E+11,25/04/23,50,0,24506.82
25/04/23,Misc,3.12E+11,25/04/23,1,0,24505.82
25/04/23,Misc,3.12E+11,25/04/23,4999,0,19506.82
25/04/23,Misc,3.48E+11,25/04/23,275,0,19231.82
25/04/23,Misc,3.12E+11,25/04/23,0,141,19372.82
25/04/23,Food,3.48E+11,25/04/23,92,0,19280.82
25/04/23,Food,3.48E+11,25/04/23,28,0,19252.82
26/04/23,Shopping,3.12E+11,26/04/23,399,0,18853.82
26/04/23,Food,3.48E+11,26/04/23,95,0,18758.82
26/04/23,Shopping,3.48E+11,26/04/23,539,0,18219.82
26/04/23,Food,3.12E+11,26/04/23,85,0,18134.82
26/04/23,Misc,3.48E+11,26/04/23,0,1000,19134.82
26/04/23,Misc,3.48E+11,26/04/23,120,0,19014.82
26/04/23,Food,3.48E+11,26/04/23,30,0,18984.82
27/04/23,Food,3.12E+11,27/04/23,30,0,18954.82
27/04/23,Shopping,3.12E+11,27/04/23,400,0,18554.82
27/04/23,Misc,3.12E+11,27/04/23,190,0,18364.82
27/04/23,Shopping,3.12E+11,27/04/23,0,400,18764.82
27/04/23,Misc,3.12E+11,27/04/23,2023,0,16741.82
27/04/23,Food,3.12E+11,27/04/23,15,0,16726.82
27/04/23,Food,3.12E+11,27/04/23,287.95,0,16438.87
27/04/23,Shopping,3.48E+11,27/04/23,700,0,15738.87
27/04/23,Food,3.48E+11,27/04/23,20,0,15718.87
27/04/23,Food,3.12E+11,27/04/23,100,0,15618.87
27/04/23,Food,3.48E+11,27/04/23,100,0,15518.87
27/04/23,Food,3.48E+11,27/04/23,28,0,15490.87
28/04/23,Food,3.12E+11,28/04/23,10,0,15480.87
28/04/23,Food,3.12E+11,28/04/23,70,0,15410.87
28/04/23,Food,3.12E+11,28/04/23,10,0,15400.87
28/04/23,Misc,3.48E+11,28/04/23,180,0,15220.87
28/04/23,Misc,3.48E+11,28/04/23,0,120,15340.87
28/04/23,Food,3.48E+11,28/04/23,30,0,15310.87
28/04/23,Food,3.48E+11,28/04/23,75,0,15235.87
28/04/23,Food,3.48E+11,28/04/23,42,0,15193.87
28/04/23,Misc,3.48E+11,28/04/23,180,0,15013.87
28/04/23,Misc,3.12E+11,28/04/23,0,90,15103.87
28/04/23,Food,3.48E+11,28/04/23,35,0,15068.87
28/04/23,Food,3.48E+11,28/04/23,30,0,15038.87
29/04/23,Misc,3.49E+11,29/04/23,220,0,14818.87
29/04/23,Food,3.49E+11,29/04/23,40,0,14778.87
29/04/23,Food,3.12E+11,29/04/23,75,0,14703.87
29/04/23,Misc,3.49E+11,29/04/23,280,0,14423.87
29/04/23,Misc,3.49E+11,29/04/23,120,0,14303.87
29/04/23,Food,3.49E+11,29/04/23,60,0,14243.87
29/04/23,Food,3.49E+11,29/04/23,40,0,14203.87
30/04/23,Food,3.12E+11,30/04/23,64,0,14139.87
30/04/23,Food,3.12E+11,30/04/23,80,0,14059.87
30/04/23,Shopping,3.49E+11,30/04/23,1044,0,13015.87
30/04/23,Food,3.49E+11,30/04/23,300.35,0,12715.52
30/04/23,Food,3.49E+11,30/04/23,85,0,12630.52
30/04/23,Misc,3.49E+11,1/5/2023,152,0,12478.52
30/04/23,Food,3.49E+11,1/5/2023,50,0,12428.52
1/5/2023,Rent,3.12E+11,1/5/2023,6463,0,5965.52
1/5/2023,Food,3.12E+11,1/5/2023,65,0,5900.52
1/5/2023,Misc,3.12E+11,1/5/2023,0,350,6250.52
1/5/2023,Misc,3.12E+11,1/5/2023,240,0,6010.52
1/5/2023,Misc,3.12E+11,1/5/2023,0,120,6130.52
1/5/2023,Food,3.12E+11,1/5/2023,35,0,6095.52
1/5/2023,Food,3.49E+11,1/5/2023,30,0,6065.52
1/5/2023,Food,3.49E+11,1/5/2023,30,0,6035.52
1/5/2023,Food,3.49E+11,1/5/2023,80,0,5955.52
2/5/2023,Food,3.49E+11,2/5/2023,260.35,0,5695.17
2/5/2023,Food,3.49E+11,2/5/2023,50,0,5645.17
2/5/2023,Food,3.12E+11,2/5/2023,10,0,5635.17
2/5/2023,Misc,3.49E+11,2/5/2023,150,0,5485.17
2/5/2023,Misc,3.49E+11,2/5/2023,0,75,5560.17
2/5/2023,Food,3.49E+11,2/5/2023,45,0,5515.17
2/5/2023,Food,3.49E+11,2/5/2023,30,0,5485.17
2/5/2023,Misc,3.49E+11,3/5/2023,1391.16,0,4094.01
3/5/2023,Food,3.49E+11,3/5/2023,69,0,4025.01
3/5/2023,Food,3.49E+11,3/5/2023,40,0,3985.01
3/5/2023,Food,3.49E+11,3/5/2023,85,0,3900.01
3/5/2023,Misc,3.49E+11,3/5/2023,180,0,3720.01
3/5/2023,Food,3.49E+11,3/5/2023,20,0,3700.01
4/5/2023,Food,3.49E+11,4/5/2023,26,0,3674.01
4/5/2023,Food,3.12E+11,4/5/2023,10,0,3664.01
4/5/2023,Food,3.49E+11,4/5/2023,30,0,3634.01
4/5/2023,Food,3.12E+11,4/5/2023,10,0,3624.01
4/5/2023,Food,3.12E+11,4/5/2023,396.9,0,3227.11
4/5/2023,Food,3.49E+11,4/5/2023,20,0,3207.11
4/5/2023,Food,3.12E+11,4/5/2023,64,0,3143.11
5/5/2023,Misc,3.49E+11,5/5/2023,0,95,3238.11
5/5/2023,Misc,3.49E+11,5/5/2023,175,0,3063.11
5/5/2023,Food,3.49E+11,5/5/2023,40,0,3023.11
5/5/2023,Food,3.13E+11,5/5/2023,76,0,2947.11
5/5/2023,Food,3.13E+11,5/5/2023,100,0,2847.11
5/5/2023,Misc,3.49E+11,5/5/2023,933,0,1914.11
5/5/2023,Food,3.49E+11,5/5/2023,40,0,1874.11
6/5/2023,Food,3.13E+11,6/5/2023,77,0,1797.11
6/5/2023,Food,3.13E+11,6/5/2023,44,0,1753.11
6/5/2023,Misc,3.13E+11,6/5/2023,150,0,1603.11
6/5/2023,Food,3.13E+11,6/5/2023,40,0,1563.11
6/5/2023,Misc,3.49E+11,6/5/2023,240,0,1323.11
6/5/2023,Food,3.49E+11,6/5/2023,30,0,1293.11
6/5/2023,Misc,3.49E+11,6/5/2023,113,0,1180.11
7/5/2023,Food,3.49E+11,7/5/2023,48,0,1132.11
7/5/2023,Misc,3.13E+11,7/5/2023,0,1132,2264.11
7/5/2023,Misc,3.49E+11,7/5/2023,0,136,2400.11
7/5/2023,Misc,3.49E+11,7/5/2023,0,636,3036.11
7/5/2023,Food,3.49E+11,7/5/2023,80,0,2956.11
7/5/2023,Food,3.49E+11,7/5/2023,10,0,2946.11
7/5/2023,Misc,3.49E+11,7/5/2023,0,936,3882.11
7/5/2023,Food,3.49E+11,7/5/2023,52,0,3830.11
7/5/2023,Food,3.49E+11,7/5/2023,20,0,3810.11
7/5/2023,Misc,3.49E+11,7/5/2023,0,681,4491.11
8/5/2023,Food,3.49E+11,8/5/2023,65,0,4426.11
8/5/2023,Food,3.49E+11,8/5/2023,40,0,4386.11
8/5/2023,Food,3.49E+11,8/5/2023,75,0,4311.11
9/5/2023,Food,3.13E+11,9/5/2023,40,0,4271.11
9/5/2023,Food,3.13E+11,9/5/2023,90,0,4181.11
9/5/2023,Food,3.13E+11,9/5/2023,10,0,4171.11
9/5/2023,Food,3.50E+11,9/5/2023,247.75,0,3923.36
9/5/2023,Food,3.50E+11,9/5/2023,100,0,3823.36
9/5/2023,Misc,3.13E+11,9/5/2023,0,10,3833.36
9/5/2023,Food,3.13E+11,9/5/2023,35,0,3798.36
9/5/2023,Misc,3.50E+11,9/5/2023,398,0,3400.36
9/5/2023,Misc,3.13E+11,9/5/2023,0,155,3555.36
9/5/2023,Food,3.50E+11,9/5/2023,60,0,3495.36
10/5/2023,Food,3.50E+11,10/5/2023,0,10,3505.36
10/5/2023,Misc,3.13E+11,10/5/2023,0,70,3575.36
10/5/2023,Misc,3.13E+11,10/5/2023,139,0,3436.36
10/5/2023,Misc,3.50E+11,10/5/2023,500,0,2936.36
10/5/2023,Misc,3.13E+11,10/5/2023,0,500,3436.36
10/5/2023,Food,3.50E+11,10/5/2023,40,0,3396.36
10/5/2023,Misc,3.50E+11,10/5/2023,284,0,3112.36
11/5/2023,Food,3.50E+11,11/5/2023,85,0,3027.36
11/5/2023,Food,3.50E+11,11/5/2023,50,0,2977.36
11/5/2023,Food,3.50E+11,11/5/2023,75,0,2902.36
11/5/2023,Misc,3.50E+11,11/5/2023,326,0,2576.36
11/5/2023,Food,3.50E+11,11/5/2023,36,0,2540.36
12/5/2023,Misc,3.50E+11,12/5/2023,0,95,2635.36
12/5/2023,Misc,3.50E+11,12/5/2023,380,0,2255.36
12/5/2023,Misc,3.50E+11,12/5/2023,0,190,2445.36
12/5/2023,Food,3.50E+11,12/5/2023,50,0,2395.36
12/5/2023,Food,3.50E+11,12/5/2023,41,0,2354.36
12/5/2023,Misc,3.13E+11,12/5/2023,1041,0,1313.36
12/5/2023,Food,3.13E+11,12/5/2023,41,0,1272.36
12/5/2023,Food,3.50E+11,12/5/2023,20,0,1252.36
12/5/2023,Food,3.50E+11,12/5/2023,30,0,1222.36
12/5/2023,Misc,3.50E+11,12/5/2023,385,0,837.36
12/5/2023,Misc,3.50E+11,12/5/2023,0,105,942.36
13/05/23,Misc,3.13E+11,13/05/23,0,130,1072.36
13/05/23,Misc,3.50E+11,13/05/23,125,0,947.36
13/05/23,Food,3.50E+11,13/05/23,40,0,907.36
13/05/23,Misc,3.50E+11,13/05/23,120,0,787.36
14/05/23,Misc,3.50E+11,14/05/23,121,0,666.36
14/05/23,Food,3.13E+11,14/05/23,40,0,626.36
14/05/23,Food,3.50E+11,14/05/23,60,0,566.36
14/05/23,Misc,3.13E+11,14/05/23,154.5,0,411.86
14/05/23,Food,3.13E+11,14/05/23,45,0,366.86
14/05/23,Food,3.50E+11,14/05/23,75,0,291.86
14/05/23,Misc,3.13E+11,14/05/23,0,60,351.86
14/05/23,Misc,3.13E+11,14/05/23,0,120,471.86
15/05/23,Misc,3.14E+11,15/05/23,0,500,971.86
15/05/23,Food,3.50E+11,15/05/23,65,0,906.86
15/05/23,Food,3.50E+11,15/05/23,50,0,856.86
15/05/23,Food,3.50E+11,15/05/23,65,0,791.86
16/05/23,Food,3.14E+11,16/05/23,54,0,737.86
16/05/23,Misc,3.50E+11,16/05/23,140,0,597.86
16/05/23,Food,3.50E+11,16/05/23,60,0,537.86
16/05/23,Food,3.50E+11,16/05/23,30,0,507.86
16/05/23,Food,3.14E+11,16/05/23,20,0,487.86
16/05/23,Misc,3.50E+11,16/05/23,101,0,386.86
17/05/23,Food,3.50E+11,17/05/23,75,0,311.86
17/05/23,Food,3.14E+11,17/05/23,60,0,251.86
17/05/23,Food,3.50E+11,17/05/23,54,0,197.86
17/05/23,Misc,3.50E+11,17/05/23,150,0,47.86
17/05/23,Food,3.50E+11,17/05/23,40,0,7.86
18/05/23,Misc,3.50E+11,18/05/23,0,170,177.86
18/05/23,Food,3.50E+11,18/05/23,80,0,97.86
18/05/23,Misc,3.50E+11,18/05/23,0,1000,1097.86
18/05/23,Food,3.50E+11,18/05/23,55,0,1042.86
18/05/23,Food,3.50E+11,18/05/23,44,0,998.86
19/05/23,Food,3.14E+11,19/05/23,50,0,948.86
19/05/23,Misc,3.51E+11,19/05/23,140,0,808.86
19/05/23,Food,3.14E+11,19/05/23,30,0,778.86
19/05/23,Food,3.51E+11,19/05/23,76,0,702.86
20/05/23,Misc,3.51E+11,20/05/23,500,0,202.86
20/05/23,Food,3.51E+11,20/05/23,33,0,169.86
20/05/23,Food,3.14E+11,20/05/23,58,0,111.86
20/05/23,Food,3.14E+11,20/05/23,95,0,16.86
21/05/23,Misc,3.51E+11,21/05/23,0,110,126.86
22/05/23,Food,3.51E+11,22/05/23,10,0,116.86
23/05/23,Food,3.51E+11,23/05/23,72,0,44.86
23/05/23,Misc,3.14E+11,23/05/23,0,300,344.86
23/05/23,Food,3.14E+11,23/05/23,90,0,254.86
23/05/23,Food,3.51E+11,23/05/23,30,0,224.86
24/05/23,Food,3.51E+11,24/05/23,30,0,194.86
25/05/23,Salary,CHASU23143454301,25/05/23,0,34800,34994.86
25/05/23,Misc,3.15E+11,25/05/23,1000,0,33994.86
25/05/23,Misc,3.15E+11,25/05/23,10000,0,23994.86
25/05/23,Misc,3.51E+11,25/05/23,270,0,23724.86
25/05/23,Food,3.51E+11,25/05/23,40,0,23684.86
25/05/23,Food,3.51E+11,25/05/23,72,0,23612.86
25/05/23,Food,3.51E+11,25/05/23,20,0,23592.86
25/05/23,Food,3.51E+11,25/05/23,363.9,0,23228.96
25/05/23,Misc,3.51E+11,25/05/23,10000,0,13228.96
25/05/23,Food,3.51E+11,25/05/23,40,0,13188.96
26/05/23,Misc,3.15E+11,26/05/23,0,10,13198.96
26/05/23,Misc,3.15E+11,26/05/23,239,0,12959.96
26/05/23,Food,3.51E+11,26/05/23,65,0,12894.96
26/05/23,Food,3.15E+11,26/05/23,50,0,12844.96
26/05/23,Misc,3.51E+11,26/05/23,2185,0,10659.96
26/05/23,Misc,3.51E+11,26/05/23,200,0,10459.96
26/05/23,Misc,3.51E+11,26/05/23,115,0,10344.96
26/05/23,Misc,3.51E+11,26/05/23,204,0,10140.96
27/05/23,Food,3.15E+11,27/05/23,10,0,10130.96
27/05/23,Food,3.15E+11,27/05/23,10,0,10120.96
27/05/23,Misc,3.51E+11,27/05/23,307,0,9813.96
27/05/23,Misc,3.51E+11,27/05/23,0,675,10488.96
27/05/23,Misc,3.51E+11,27/05/23,1500,0,8988.96
27/05/23,Misc,3.51E+11,27/05/23,180,0,8808.96
27/05/23,Food,3.51E+11,27/05/23,20,0,8788.96
27/05/23,Misc,3.15E+11,27/05/23,0,675,9463.96
28/05/23,Shopping,3.51E+11,28/05/23,197,0,9266.96
28/05/23,Food,3.51E+11,28/05/23,80,0,9186.96
28/05/23,Food,3.51E+11,28/05/23,100,0,9086.96
28/05/23,Food,3.51E+11,28/05/23,55,0,9031.96
28/05/23,Misc,3.15E+11,28/05/23,364,0,8667.96
28/05/23,Shopping,3.15E+11,28/05/23,186,0,8481.96
28/05/23,Food,3.51E+11,28/05/23,30,0,8451.96
1/6/2023,Shopping,3.15E+11,1/6/2023,0,186,8637.96
2/6/2023,Food,3.52E+11,2/6/2023,30,0,8607.96
2/6/2023,Misc,3.52E+11,2/6/2023,160,0,8447.96
2/6/2023,Food,3.52E+11,2/6/2023,90,0,8357.96
3/6/2023,Shopping,3.15E+11,3/6/2023,454,0,7903.96
3/6/2023,Food,3.15E+11,3/6/2023,30,0,7873.96
3/6/2023,Misc,3.52E+11,3/6/2023,170.01,0,7703.95
3/6/2023,Misc,3.52E+11,3/6/2023,105,0,7598.95
3/6/2023,Food,3.15E+11,3/6/2023,35,0,7563.95
3/6/2023,Food,3.15E+11,3/6/2023,20,0,7543.95
3/6/2023,Misc,3.15E+11,3/6/2023,0,130,7673.95
3/6/2023,Food,3.52E+11,3/6/2023,36,0,7637.95
3/6/2023,Misc,3.52E+11,3/6/2023,390,0,7247.95
3/6/2023,Food,3.52E+11,3/6/2023,50,0,7197.95
4/6/2023,Food,3.52E+11,4/6/2023,35,0,7162.95
4/6/2023,Misc,3.52E+11,4/6/2023,963,0,6199.95
4/6/2023,Misc,3.52E+11,4/6/2023,0,190,6389.95
4/6/2023,Food,3.16E+11,4/6/2023,65,0,6324.95
4/6/2023,Food,3.52E+11,4/6/2023,384.9,0,5940.05
4/6/2023,Food,3.52E+11,4/6/2023,20,0,5920.05
5/6/2023,Food,3.16E+11,5/6/2023,34,0,5886.05
5/6/2023,Food,3.52E+11,5/6/2023,65,0,5821.05
5/6/2023,Food,3.16E+11,5/6/2023,40,0,5781.05
5/6/2023,Misc,3.52E+11,5/6/2023,628,0,5153.05
5/6/2023,Misc,3.52E+11,5/6/2023,8,0,5145.05
6/6/2023,Food,3.52E+11,6/6/2023,30,0,5115.05
6/6/2023,Food,3.52E+11,6/6/2023,251.25,0,4863.8
6/6/2023,Food,3.52E+11,6/6/2023,20,0,4843.8
6/6/2023,Food,3.52E+11,6/6/2023,50,0,4793.8
6/6/2023,Food,3.52E+11,6/6/2023,14.25,0,4779.55
6/6/2023,Misc,3.16E+11,6/6/2023,150,0,4629.55
6/6/2023,Misc,3.52E+11,6/6/2023,515,0,4114.55
6/6/2023,Food,3.52E+11,7/6/2023,50,0,4064.55
7/6/2023,Food,3.52E+11,7/6/2023,80,0,3984.55
7/6/2023,Food,3.52E+11,7/6/2023,40,0,3944.55
7/6/2023,Food,3.16E+11,7/6/2023,40,0,3904.55
7/6/2023,Food,3.16E+11,7/6/2023,40,0,3864.55
7/6/2023,Misc,3.52E+11,7/6/2023,0,1600,5464.55
7/6/2023,Misc,3.52E+11,7/6/2023,130,0,5334.55
8/6/2023,Food,3.16E+11,8/6/2023,34,0,5300.55
8/6/2023,Misc,3.53E+11,8/6/2023,125,0,5175.55
8/6/2023,Misc,3.53E+11,8/6/2023,0,65,5240.55
8/6/2023,Food,3.16E+11,8/6/2023,10,0,5230.55
8/6/2023,Food,3.53E+11,8/6/2023,50,0,5180.55
8/6/2023,Food,3.16E+11,8/6/2023,50,0,5130.55
8/6/2023,Food,3.53E+11,8/6/2023,70,0,5060.55
8/6/2023,Food,3.53E+11,8/6/2023,40,0,5020.55
9/6/2023,Misc,3.16E+11,9/6/2023,0,72,5092.55
9/6/2023,Misc,3.53E+11,9/6/2023,137,0,4955.55
9/6/2023,Misc,3.53E+11,9/6/2023,0,171,5126.55
9/6/2023,Food,3.53E+11,9/6/2023,50,0,5076.55
9/6/2023,Food,3.16E+11,9/6/2023,60,0,5016.55
9/6/2023,Misc,3.53E+11,9/6/2023,0,8000,13016.55
9/6/2023,Misc,3.53E+11,9/6/2023,8000,0,5016.55
9/6/2023,Misc,3.53E+11,9/6/2023,125,0,4891.55
10/6/2023,Food,3.53E+11,10/6/2023,40,0,4851.55
10/6/2023,Food,3.53E+11,10/6/2023,70,0,4781.55
10/6/2023,Misc,3.16E+11,10/6/2023,150,0,4631.55
10/6/2023,Misc,3.53E+11,10/6/2023,344,0,4287.55
10/6/2023,Food,3.53E+11,10/6/2023,30,0,4257.55
11/6/2023,Misc,3.53E+11,11/6/2023,450,0,3807.55
11/6/2023,Misc,3.53E+11,11/6/2023,350,0,3457.55
11/6/2023,Misc,3.53E+11,11/6/2023,140,0,3317.55
12/6/2023,Food,3.53E+11,12/6/2023,44,0,3273.55
12/6/2023,Food,3.53E+11,12/6/2023,40,0,3233.55
12/6/2023,Misc,3.16E+11,12/6/2023,0,3000,6233.55
12/6/2023,Misc,3.16E+11,12/6/2023,3000,0,3233.55
12/6/2023,Food,3.16E+11,12/6/2023,34,0,3199.55
12/6/2023,Food,3.53E+11,12/6/2023,50,0,3149.55
12/6/2023,Food,3.53E+11,12/6/2023,25,0,3124.55
12/6/2023,Food,3.53E+11,12/6/2023,56,0,3068.55
13/06/23,Food,3.53E+11,13/06/23,55,0,3013.55
13/06/23,Food,3.53E+11,13/06/23,30,0,2983.55
13/06/23,Food,3.53E+11,13/06/23,50,0,2933.55
13/06/23,Food,3.53E+11,13/06/23,100,0,2833.55
13/06/23,Food,3.16E+11,13/06/23,20,0,2813.55
13/06/23,Food,3.16E+11,13/06/23,30,0,2783.55
13/06/23,Misc,3.53E+11,13/06/23,0,1000,3783.55
13/06/23,Food,3.53E+11,13/06/23,28,0,3755.55
14/06/23,Food,3.17E+11,14/06/23,40,0,3715.55
14/06/23,Misc,3.53E+11,14/06/23,1100,0,2615.55
14/06/23,Misc,3.17E+11,14/06/23,125,0,2490.55
14/06/23,Food,3.17E+11,14/06/23,100,0,2390.55
14/06/23,Misc,3.53E+11,14/06/23,385,0,2005.55
14/06/23,Misc,3.17E+11,14/06/23,750,0,1255.55
15/06/23,Food,3.17E+11,15/06/23,10,0,1245.55
15/06/23,Misc,3.17E+11,15/06/23,138,0,1107.55
15/06/23,Food,3.17E+11,15/06/23,10,0,1097.55
16/06/23,Food,3.17E+11,16/06/23,100,0,997.55
16/06/23,Food,3.17E+11,16/06/23,60,0,937.55
16/06/23,Food,3.53E+11,16/06/23,100,0,837.55
17/06/23,Food,3.53E+11,17/06/23,60,0,777.55
17/06/23,Food,3.53E+11,17/06/23,10,0,767.55
18/06/23,Food,3.17E+11,18/06/23,20,0,747.55
18/06/23,Food,3.17E+11,18/06/23,10,0,737.55
18/06/23,Food,3.54E+11,18/06/23,20,0,717.55
18/06/23,Food,3.54E+11,18/06/23,40,0,677.55
18/06/23,Food,3.54E+11,18/06/23,50,0,627.55
19/06/23,Food,3.54E+11,19/06/23,20,0,607.55
19/06/23,Misc,3.17E+11,19/06/23,0,400,1007.55
19/06/23,Misc,3.54E+11,19/06/23,327,0,680.55
20/06/23,Food,3.54E+11,20/06/23,25,0,655.55
21/06/23,Food,3.54E+11,21/06/23,20,0,635.55
21/06/23,Food,3.54E+11,21/06/23,55,0,580.55
21/06/23,Food,3.54E+11,21/06/23,40,0,540.55
21/06/23,Food,3.54E+11,21/06/23,10,0,530.55
21/06/23,Food,3.54E+11,21/06/23,20,0,510.55
21/06/23,Misc,3.17E+11,21/06/23,8.26,0,502.29
23/06/23,Salary,CHASU23172917734,23/06/23,0,34800,35302.29
23/06/23,Misc,3.17E+11,23/06/23,2000,0,33302.29
23/06/23,Misc,3.54E+11,23/06/23,3000,0,30302.29
24/06/23,Misc,3.18E+11,24/06/23,10000,0,20302.29
24/06/23,Misc,3.18E+11,24/06/23,1000,0,19302.29
24/06/23,Food,3.18E+11,24/06/23,100,0,19202.29
24/06/23,Misc,3.18E+11,24/06/23,409,0,18793.29
24/06/23,Misc,3.18E+11,24/06/23,200,0,18593.29
24/06/23,Misc,3.18E+11,24/06/23,424,0,18169.29
25/06/23,Misc,3.54E+11,25/06/23,600,0,17569.29
25/06/23,Food,3.54E+11,25/06/23,100,0,17469.29
26/06/23,Misc,3.54E+11,26/06/23,5000,0,12469.29
26/06/23,Misc,3.18E+11,26/06/23,528.44,0,11940.85
26/06/23,Misc,3.18E+11,26/06/23,0,1,11941.85
27/06/23,Food,3.54E+11,27/06/23,100,0,11841.85
27/06/23,Misc,3.18E+11,27/06/23,2100,0,9741.85
27/06/23,Misc,3.54E+11,27/06/23,119,0,9622.85
28/06/23,Misc,3.18E+11,28/06/23,500,0,9122.85
28/06/23,Misc,3.55E+11,28/06/23,7630,0,1492.85
30/06/23,Misc,3.55E+11,30/06/23,467,0,1025.85
1/7/2023,Misc,0,30/06/23,0,34,1059.85
1/7/2023,Food,3.55E+11,1/7/2023,20,0,1039.85
1/7/2023,Food,3.18E+11,1/7/2023,20,0,1019.85
1/7/2023,Food,3.18E+11,1/7/2023,20,0,999.85
2/7/2023,Misc,3.18E+11,1/7/2023,0,10,1009.85
4/7/2023,Misc,3.55E+11,4/7/2023,125,0,884.85
5/7/2023,Food,3.55E+11,5/7/2023,40,0,844.85
5/7/2023,Food,3.19E+11,5/7/2023,50,0,794.85
8/7/2023,Misc,3.07E+11,8/7/2023,0,1.13,795.98
8/7/2023,Food,3.56E+11,8/7/2023,50,0,745.98
8/7/2023,Misc,3.56E+11,8/7/2023,0,7800,8545.98
8/7/2023,Misc,3.56E+11,9/7/2023,7800,0,745.98
9/7/2023,Shopping,3.19E+11,9/7/2023,184,0,561.98
10/7/2023,Misc,3.56E+11,10/7/2023,0,2500,3061.98
10/7/2023,Food,3.19E+11,10/7/2023,100,0,2961.98
10/7/2023,Misc,3.19E+11,10/7/2023,1100,0,1861.98
10/7/2023,Food,3.56E+11,10/7/2023,30,0,1831.98
11/7/2023,Food,3.19E+11,11/7/2023,20,0,1811.98
11/7/2023,Misc,3.19E+11,11/7/2023,170,0,1641.98
11/7/2023,Misc,3.19E+11,11/7/2023,140,0,1501.98
11/7/2023,Food,3.19E+11,11/7/2023,20,0,1481.98
11/7/2023,Food,3.19E+11,11/7/2023,20,0,1461.98
12/7/2023,Misc,3.07E+11,12/7/2023,0,125.96,1587.94
12/7/2023,Misc,3.56E+11,12/7/2023,125,0,1462.94
12/7/2023,Food,3.19E+11,12/7/2023,24,0,1438.94
12/7/2023,Food,3.19E+11,12/7/2023,10,0,1428.94
12/7/2023,Food,3.19E+11,12/7/2023,30,0,1398.94
13/07/23,Food,3.19E+11,13/07/23,60,0,1338.94
13/07/23,Food,3.56E+11,13/07/23,198.32,0,1140.62
13/07/23,Food,3.19E+11,13/07/23,50,0,1090.62
13/07/23,Food,3.19E+11,13/07/23,50,0,1040.62
13/07/23,Food,3.19E+11,13/07/23,20,0,1020.62
13/07/23,Food,3.19E+11,13/07/23,10,0,1010.62
14/07/23,Misc,3.20E+11,14/07/23,5,0,1005.62
14/07/23,Misc,3.20E+11,14/07/23,270,0,735.62
14/07/23,Food,3.20E+11,14/07/23,70,0,665.62
14/07/23,Food,3.20E+11,14/07/23,10,0,655.62
14/07/23,Food,3.20E+11,14/07/23,40,0,615.62
14/07/23,Food,3.20E+11,14/07/23,71,0,544.62
15/07/23,Food,3.20E+11,15/07/23,40,0,504.62
15/07/23,Food,3.20E+11,15/07/23,40,0,464.62
15/07/23,Misc,3.20E+11,15/07/23,345,0,119.62
16/07/23,Food,3.20E+11,16/07/23,20,0,99.62
16/07/23,Food,3.20E+11,16/07/23,40,0,59.62
16/07/23,Food,3.20E+11,16/07/23,20,0,39.62
17/07/23,Food,3.20E+11,17/07/23,30,0,9.62
19/07/23,Misc,3.57E+11,19/07/23,0,1000,1009.62
20/07/23,Food,3.20E+11,20/07/23,100,0,909.62
20/07/23,Food,3.20E+11,20/07/23,30,0,879.62
20/07/23,Food,3.20E+11,20/07/23,70,0,809.62
20/07/23,Food,3.20E+11,20/07/23,50,0,759.62
20/07/23,Food,3.20E+11,20/07/23,40,0,719.62
20/07/23,Misc,3.20E+11,20/07/23,207,0,512.62
21/07/23,Food,3.20E+11,21/07/23,92,0,420.62
21/07/23,Misc,3.20E+11,21/07/23,250,0,170.62
21/07/23,Misc,3.20E+11,21/07/23,0,1000,1170.62
21/07/23,Food,3.20E+11,21/07/23,58,0,1112.62
21/07/23,Misc,3.20E+11,21/07/23,220,0,892.62
21/07/23,Food,3.20E+11,21/07/23,50,0,842.62
22/07/23,Food,3.20E+11,22/07/23,100,0,742.62
22/07/23,Food,3.20E+11,22/07/23,41,0,701.62
22/07/23,Food,3.20E+11,22/07/23,41,0,660.62
22/07/23,Food,3.20E+11,22/07/23,50,0,610.62
22/07/23,Food,3.20E+11,22/07/23,90,0,520.62
22/07/23,Food,3.20E+11,22/07/23,40,0,480.62
22/07/23,Food,3.20E+11,22/07/23,10,0,470.62
22/07/23,Food,3.20E+11,22/07/23,30,0,440.62
23/07/23,Misc,3.57E+11,23/07/23,0,500,940.62
23/07/23,Food,3.20E+11,23/07/23,10,0,930.62
23/07/23,Misc,3.20E+11,23/07/23,160,0,770.62
23/07/23,Food,3.20E+11,23/07/23,30,0,740.62
23/07/23,Food,3.20E+11,23/07/23,30,0,710.62
23/07/23,Misc,3.20E+11,23/07/23,180,0,530.62
23/07/23,Food,3.20E+11,23/07/23,51,0,479.62
23/07/23,Food,3.20E+11,23/07/23,10,0,469.62
24/07/23,Food,3.21E+11,24/07/23,20,0,449.62
24/07/23,Food,3.21E+11,24/07/23,20,0,429.62
24/07/23,Misc,3.21E+11,24/07/23,170,0,259.62
24/07/23,Food,3.21E+11,24/07/23,50,0,209.62
24/07/23,Food,3.21E+11,24/07/23,50,0,159.62
25/07/23,Salary,CHASV23202393703,25/07/23,0,34800,34959.62
25/07/23,Shopping,3.21E+11,25/07/23,2553,0,32406.62
25/07/23,Misc,3.21E+11,25/07/23,10000,0,22406.62
25/07/23,Food,3.57E+11,25/07/23,50,0,22356.62
25/07/23,Misc,3.21E+11,25/07/23,1001,0,21355.62
25/07/23,Misc,3.21E+11,25/07/23,130,0,21225.62
25/07/23,Food,3.21E+11,25/07/23,60,0,21165.62
25/07/23,Misc,3.21E+11,25/07/23,7500,0,13665.62
25/07/23,Food,3.21E+11,25/07/23,70,0,13595.62
25/07/23,Misc,3.21E+11,25/07/23,350,0,13245.62
25/07/23,Food,3.21E+11,25/07/23,30,0,13215.62
25/07/23,Shopping,3.57E+11,26/07/23,259,0,12956.62
26/07/23,Shopping,3.21E+11,26/07/23,0,259,13215.62
26/07/23,Shopping,3.21E+11,26/07/23,249,0,12966.62
26/07/23,Misc,3.21E+11,26/07/23,1000,0,11966.62
26/07/23,Food,3.21E+11,26/07/23,40,0,11926.62
26/07/23,Misc,3.21E+11,26/07/23,1500,0,10426.62
26/07/23,Misc,3.21E+11,26/07/23,150,0,10276.62
26/07/23,Food,3.21E+11,26/07/23,60,0,10216.62
26/07/23,Misc,3.21E+11,26/07/23,480,0,9736.62
26/07/23,Food,3.21E+11,26/07/23,40,0,9696.62
26/07/23,Misc,3.21E+11,26/07/23,200,0,9496.62
27/07/23,Misc,3.21E+11,27/07/23,108,0,9388.62
27/07/23,Food,3.21E+11,27/07/23,100,0,9288.62
27/07/23,Misc,3.21E+11,27/07/23,175,0,9113.62
27/07/23,Misc,3.21E+11,27/07/23,150,0,8963.62
27/07/23,Food,3.21E+11,27/07/23,20,0,8943.62
27/07/23,Food,3.21E+11,27/07/23,30,0,8913.62
27/07/23,Misc,3.21E+11,27/07/23,5,0,8908.62
27/07/23,Shopping,3.57E+11,27/07/23,199,0,8709.62
27/07/23,Food,3.21E+11,27/07/23,75,0,8634.62
27/07/23,Food,3.21E+11,27/07/23,20,0,8614.62
28/07/23,Food,3.58E+11,28/07/23,30,0,8584.62
28/07/23,Food,3.21E+11,28/07/23,23,0,8561.62
28/07/23,Food,3.21E+11,28/07/23,10,0,8551.62
28/07/23,Food,3.21E+11,28/07/23,60,0,8491.62
29/07/23,Food,3.21E+11,29/07/23,50,0,8441.62
29/07/23,Food,3.21E+11,29/07/23,40,0,8401.62
29/07/23,Misc,3.21E+11,29/07/23,160,0,8241.62
29/07/23,Misc,3.21E+11,29/07/23,320,0,7921.62
30/07/23,Food,3.21E+11,30/07/23,50,0,7871.62
30/07/23,Misc,3.21E+11,30/07/23,170,0,7701.62
30/07/23,Food,3.21E+11,30/07/23,20,0,7681.62
30/07/23,Food,3.21E+11,30/07/23,30,0,7651.62
30/07/23,Food,3.21E+11,30/07/23,20,0,7631.62
31/07/23,Misc,3.21E+11,31/07/23,110,0,7521.62
1/8/2023,Misc,MIR2421393691857,1/8/2023,236,0,7285.62
1/8/2023,Food,3.21E+11,1/8/2023,15,0,7270.62
1/8/2023,Food,3.21E+11,1/8/2023,30,0,7240.62
2/8/2023,Misc,3.21E+11,2/8/2023,0,2000,9240.62
2/8/2023,Rent,3.21E+11,2/8/2023,7459,0,1781.62
2/8/2023,Misc,3.21E+11,2/8/2023,243,0,1538.62
2/8/2023,Misc,3.21E+11,2/8/2023,999,0,539.62
2/8/2023,Food,3.21E+11,2/8/2023,10,0,529.62
2/8/2023,Food,3.21E+11,2/8/2023,90,0,439.62
2/8/2023,Food,3.21E+11,2/8/2023,24,0,415.62
2/8/2023,Misc,3.21E+11,2/8/2023,6,0,409.62
2/8/2023,Misc,3.21E+11,2/8/2023,140,0,269.62
2/8/2023,Food,3.21E+11,2/8/2023,30,0,239.62
3/8/2023,Food,3.58E+11,3/8/2023,55,0,184.62
3/8/2023,Food,3.22E+11,3/8/2023,40,0,144.62
3/8/2023,Food,3.22E+11,3/8/2023,40,0,104.62
3/8/2023,Food,3.22E+11,3/8/2023,40,0,64.62
4/8/2023,Food,3.22E+11,4/8/2023,20,0,44.62
5/8/2023,Misc,3.58E+11,5/8/2023,0,13000,13044.62
5/8/2023,Misc,3.22E+11,5/8/2023,13000,0,44.62
11/8/2023,Misc,3.22E+11,11/8/2023,0,1000,1044.62
11/8/2023,Food,3.22E+11,11/8/2023,85,0,959.62
11/8/2023,Food,3.22E+11,11/8/2023,30,0,929.62
11/8/2023,Food,3.22E+11,11/8/2023,50,0,879.62
11/8/2023,Misc,3.22E+11,11/8/2023,179,0,700.62
11/8/2023,Food,3.59E+11,11/8/2023,10,0,690.62
11/8/2023,Food,3.59E+11,11/8/2023,60,0,630.62
12/8/2023,Misc,3.22E+11,12/8/2023,393,0,237.62
12/8/2023,Food,3.22E+11,12/8/2023,30,0,207.62
12/8/2023,Food,3.22E+11,12/8/2023,66,0,141.62
13/08/23,Misc,3.23E+11,13/08/23,0,2000,2141.62
13/08/23,Food,3.23E+11,13/08/23,80,0,2061.62
13/08/23,Food,3.23E+11,13/08/23,50,0,2011.62
13/08/23,Misc,3.23E+11,13/08/23,130,0,1881.62
13/08/23,Misc,3.23E+11,13/08/23,189,0,1692.62
13/08/23,Food,3.23E+11,13/08/23,30,0,1662.62
13/08/23,Misc,3.23E+11,13/08/23,500,0,1162.62
13/08/23,Food,3.23E+11,14/08/23,10,0,1152.62
14/08/23,Food,3.23E+11,14/08/23,99,0,1053.62
14/08/23,Food,3.23E+11,14/08/23,50,0,1003.62
14/08/23,Food,3.23E+11,14/08/23,50,0,953.62
14/08/23,Misc,3.23E+11,14/08/23,358,0,595.62
14/08/23,Food,3.23E+11,14/08/23,30,0,565.62
15/08/23,Food,3.23E+11,15/08/23,20,0,545.62
15/08/23,Food,3.23E+11,15/08/23,40,0,505.62
15/08/23,Food,3.23E+11,15/08/23,30,0,475.62
15/08/23,Misc,3.23E+11,15/08/23,0,25,500.62
16/08/23,Food,3.23E+11,16/08/23,60,0,440.62
16/08/23,Food,3.23E+11,16/08/23,10,0,430.62
16/08/23,Food,3.23E+11,16/08/23,40,0,390.62
16/08/23,Food,3.23E+11,16/08/23,42,0,348.62
16/08/23,Misc,3.23E+11,16/08/23,230,0,118.62
16/08/23,Food,3.23E+11,16/08/23,40,0,78.62
17/08/23,Food,3.23E+11,17/08/23,50,0,28.62
17/08/23,Misc,3.23E+11,17/08/23,0,1500,1528.62
17/08/23,Misc,3.23E+11,17/08/23,1000,0,528.62
17/08/23,Food,3.23E+11,17/08/23,50,0,478.62
17/08/23,Food,3.60E+11,17/08/23,161.55,0,317.07
18/08/23,Food,3.23E+11,18/08/23,60,0,257.07
18/08/23,Food,3.23E+11,18/08/23,40,0,217.07
18/08/23,Food,3.60E+11,18/08/23,67.2,0,149.87
18/08/23,Food,3.23E+11,18/08/23,20,0,129.87
18/08/23,Misc,3.23E+11,18/08/23,0,1000,1129.87
18/08/23,Food,3.23E+11,18/08/23,86,0,1043.87
18/08/23,Misc,3.60E+11,18/08/23,276,0,767.87
18/08/23,Food,3.23E+11,18/08/23,50,0,717.87
19/08/23,Misc,3.23E+11,19/08/23,390,0,327.87
19/08/23,Food,3.23E+11,19/08/23,40,0,287.87
19/08/23,Misc,3.23E+11,19/08/23,0,1000,1287.87
19/08/23,Food,3.23E+11,19/08/23,50,0,1237.87
19/08/23,Food,3.23E+11,19/08/23,40,0,1197.87
20/08/23,Food,3.23E+11,20/08/23,20,0,1177.87
20/08/23,Food,3.23E+11,20/08/23,30,0,1147.87
20/08/23,Food,3.23E+11,20/08/23,60,0,1087.87
20/08/23,Food,3.23E+11,20/08/23,60,0,1027.87
20/08/23,Misc,3.23E+11,20/08/23,5,0,1022.87
20/08/23,Food,3.60E+11,20/08/23,174.95,0,847.92
20/08/23,Food,3.23E+11,20/08/23,40,0,807.92
20/08/23,Misc,3.23E+11,20/08/23,400,0,407.92
20/08/23,Food,3.23E+11,21/08/23,20,0,387.92
21/08/23,Misc,3.23E+11,21/08/23,160,0,227.92
21/08/23,Food,3.23E+11,21/08/23,50,0,177.92
21/08/23,Food,3.23E+11,21/08/23,22,0,155.92
21/08/23,Food,3.60E+11,21/08/23,75,0,80.92
21/08/23,Food,3.23E+11,21/08/23,40,0,40.92
22/08/23,Misc,3.23E+11,22/08/23,0,1000,1040.92
22/08/23,Food,3.60E+11,22/08/23,70,0,970.92
22/08/23,Misc,3.23E+11,22/08/23,0,70,1040.92
22/08/23,Food,3.60E+11,22/08/23,55,0,985.92
22/08/23,Food,3.23E+11,22/08/23,50,0,935.92
22/08/23,Food,3.23E+11,22/08/23,10,0,925.92
22/08/23,Food,3.23E+11,22/08/23,38,0,887.92
22/08/23,Food,3.23E+11,22/08/23,20,0,867.92
23/08/23,Food,3.60E+11,23/08/23,28,0,839.92
23/08/23,Food,3.24E+11,23/08/23,23,0,816.92
23/08/23,Food,3.24E+11,23/08/23,30,0,786.92
23/08/23,Food,3.24E+11,23/08/23,50,0,736.92
23/08/23,Food,3.24E+11,23/08/23,30,0,706.92
23/08/23,Misc,3.24E+11,23/08/23,200,0,506.92
24/08/23,Food,3.24E+11,24/08/23,201,0,305.92
24/08/23,Food,3.24E+11,24/08/23,100,0,205.92
24/08/23,Food,3.24E+11,24/08/23,50,0,155.92
24/08/23,Food,3.24E+11,24/08/23,59,0,96.92
24/08/23,Food,3.24E+11,24/08/23,50,0,46.92
25/08/23,Salary,CHASV23235906561,25/08/23,0,34800,34846.92
25/08/23,Misc,3.60E+11,25/08/23,5000,0,29846.92
25/08/23,Misc,3.60E+11,25/08/23,8000,0,21846.92
25/08/23,Misc,3.60E+11,25/08/23,1000,0,20846.92
25/08/23,Misc,3.60E+11,25/08/23,1000,0,19846.92
25/08/23,Food,3.24E+11,25/08/23,34,0,19812.92
25/08/23,Misc,3.24E+11,25/08/23,1000,0,18812.92
25/08/23,Misc,3.24E+11,25/08/23,380,0,18432.92
25/08/23,Misc,3.60E+11,25/08/23,0,140,18572.92
25/08/23,Food,3.24E+11,25/08/23,100,0,18472.92
25/08/23,Misc,3.24E+11,25/08/23,1720,0,16752.92
25/08/23,Misc,3.24E+11,25/08/23,200,0,16552.92
25/08/23,Misc,3.24E+11,25/08/23,188,0,16364.92
25/08/23,Food,3.24E+11,25/08/23,40,0,16324.92
25/08/23,Food,3.24E+11,25/08/23,70,0,16254.92
25/08/23,Misc,3.60E+11,25/08/23,0,15,16269.92
25/08/23,Food,3.24E+11,25/08/23,50,0,16219.92
26/08/23,Misc,3.24E+11,26/08/23,120,0,16099.92
26/08/23,Food,3.24E+11,26/08/23,30,0,16069.92
26/08/23,Misc,3.24E+11,26/08/23,430,0,15639.92
26/08/23,Misc,3.60E+11,26/08/23,0,70,15709.92
26/08/23,Misc,3.24E+11,26/08/23,112,0,15597.92
26/08/23,Misc,3.60E+11,26/08/23,0,10,15607.92
26/08/23,Misc,3.24E+11,26/08/23,118,0,15489.92
26/08/23,Food,3.24E+11,26/08/23,10,0,15479.92
26/08/23,Misc,3.24E+11,26/08/23,1000,0,14479.92
26/08/23,Food,3.60E+11,26/08/23,188.2,0,14291.72
26/08/23,Food,3.60E+11,26/08/23,40,0,14251.72
27/08/23,Misc,3.24E+11,27/08/23,199,0,14052.72
27/08/23,Food,3.24E+11,27/08/23,30,0,14022.72
27/08/23,Food,3.24E+11,27/08/23,58,0,13964.72
27/08/23,Misc,3.61E+11,27/08/23,0,12,13976.72
27/08/23,Food,3.24E+11,27/08/23,100,0,13876.72
27/08/23,Food,3.24E+11,27/08/23,50,0,13826.72
28/08/23,Food,3.24E+11,28/08/23,203.66,0,13623.06
28/08/23,Misc,3.61E+11,28/08/23,105,0,13518.06
28/08/23,Food,3.24E+11,29/08/23,40,0,13478.06
29/08/23,Misc,3.24E+11,29/08/23,5,0,13473.06
29/08/23,Food,3.61E+11,29/08/23,23,0,13450.06
29/08/23,Food,3.24E+11,29/08/23,30,0,13420.06
29/08/23,Food,3.24E+11,29/08/23,43,0,13377.06
29/08/23,Food,3.24E+11,29/08/23,10,0,13367.06
29/08/23,Food,3.61E+11,29/08/23,185.2,0,13181.86
30/08/23,Misc,3.61E+11,30/08/23,110,0,13071.86
30/08/23,Misc,3.24E+11,30/08/23,0,55,13126.86
30/08/23,Food,3.24E+11,30/08/23,40,0,13086.86
30/08/23,Food,3.61E+11,30/08/23,100,0,12986.86
30/08/23,Food,3.24E+11,30/08/23,40,0,12946.86
31/08/23,Food,3.24E+11,31/08/23,30,0,12916.86
31/08/23,Food,3.61E+11,31/08/23,100,0,12816.86
31/08/23,Food,3.24E+11,31/08/23,30,0,12786.86
31/08/23,Misc,3.24E+11,31/08/23,0,20000,32786.86
31/08/23,Misc,3.24E+11,31/08/23,20000,0,12786.86
31/08/23,Misc,3.24E+11,31/08/23,440,0,12346.86
1/9/2023,Rent,3.24E+11,1/9/2023,7310,0,5036.86
1/9/2023,Misc,3.24E+11,1/9/2023,110,0,4926.86
1/9/2023,Food,3.24E+11,1/9/2023,20,0,4906.86
1/9/2023,Food,3.24E+11,1/9/2023,30,0,4876.86
1/9/2023,Misc,3.24E+11,1/9/2023,447,0,4429.86
1/9/2023,Food,3.24E+11,1/9/2023,52,0,4377.86
1/9/2023,Food,3.24E+11,1/9/2023,20,0,4357.86
2/9/2023,Food,3.61E+11,2/9/2023,188.2,0,4169.66
2/9/2023,Food,3.25E+11,2/9/2023,50,0,4119.66
2/9/2023,Food,3.61E+11,2/9/2023,136.76,0,3982.9
2/9/2023,Food,3.25E+11,2/9/2023,0,136.76,4119.66
3/9/2023,Food,3.25E+11,3/9/2023,30,0,4089.66
3/9/2023,Food,3.25E+11,3/9/2023,36,0,4053.66
3/9/2023,Food,3.25E+11,3/9/2023,60,0,3993.66
3/9/2023,Food,3.25E+11,3/9/2023,20,0,3973.66
4/9/2023,Food,3.25E+11,4/9/2023,30,0,3943.66
4/9/2023,Food,3.25E+11,4/9/2023,55,0,3888.66
4/9/2023,Misc,3.25E+11,4/9/2023,250,0,3638.66
4/9/2023,Food,3.25E+11,4/9/2023,30,0,3608.66
5/9/2023,Food,3.25E+11,5/9/2023,80,0,3528.66
5/9/2023,Food,3.25E+11,5/9/2023,50,0,3478.66
5/9/2023,Misc,3.61E+11,6/9/2023,1000,0,2478.66
6/9/2023,Food,3.62E+11,6/9/2023,55,0,2423.66
6/9/2023,Food,3.25E+11,6/9/2023,40,0,2383.66
6/9/2023,Food,3.62E+11,6/9/2023,217.95,0,2165.71
6/9/2023,Food,3.25E+11,6/9/2023,60,0,2105.71
7/9/2023,Misc,3.25E+11,7/9/2023,170,0,1935.71
7/9/2023,Misc,3.25E+11,7/9/2023,200,0,1735.71
7/9/2023,Food,3.25E+11,7/9/2023,40,0,1695.71
7/9/2023,Food,3.25E+11,7/9/2023,80,0,1615.71
7/9/2023,Food,3.25E+11,7/9/2023,85,0,1530.71
8/9/2023,Food,3.25E+11,8/9/2023,25,0,1505.71
8/9/2023,Food,3.25E+11,8/9/2023,40,0,1465.71
8/9/2023,Misc,3.25E+11,8/9/2023,0,80,1545.71
8/9/2023,Misc,3.62E+11,8/9/2023,190,0,1355.71
9/9/2023,Misc,3.25E+11,9/9/2023,279.5,0,1076.21
9/9/2023,Food,3.25E+11,9/9/2023,52,0,1024.21
9/9/2023,Food,3.25E+11,9/9/2023,30,0,994.21
9/9/2023,Food,3.25E+11,9/9/2023,10,0,984.21
9/9/2023,Food,3.25E+11,9/9/2023,40,0,944.21
10/9/2023,Food,3.25E+11,10/9/2023,230.7,0,713.51
10/9/2023,Food,3.25E+11,10/9/2023,54,0,659.51
10/9/2023,Misc,3.62E+11,10/9/2023,0,500,1159.51
10/9/2023,Food,3.62E+11,10/9/2023,426.94,0,732.57
11/9/2023,Food,3.25E+11,11/9/2023,192.24,0,540.33
11/9/2023,Food,3.25E+11,11/9/2023,55,0,485.33
11/9/2023,Food,3.25E+11,11/9/2023,80,0,405.33
11/9/2023,Food,3.25E+11,11/9/2023,20,0,385.33
11/9/2023,Food,3.25E+11,11/9/2023,10,0,375.33
11/9/2023,Food,3.25E+11,11/9/2023,10,0,365.33
11/9/2023,Misc,3.25E+11,11/9/2023,125,0,240.33
12/9/2023,Food,3.26E+11,12/9/2023,30,0,210.33
12/9/2023,Food,3.26E+11,12/9/2023,55,0,155.33
12/9/2023,Food,3.26E+11,12/9/2023,40,0,115.33
12/9/2023,Food,3.26E+11,12/9/2023,60,0,55.33
12/9/2023,Food,3.26E+11,12/9/2023,10,0,45.33
13/09/23,Food,3.62E+11,13/09/23,23,0,22.33
16/09/23,Food,3.26E+11,16/09/23,10,0,12.33
23/09/23,Misc,3.27E+11,23/09/23,0,1000,1012.33
23/09/23,Misc,3.27E+11,23/09/23,300.1,0,712.23
23/09/23,Misc,3.27E+11,23/09/23,700,0,12.23
25/09/23,Salary,CHASH26441571950,25/09/23,0,34800,34812.23
25/09/23,Misc,3.27E+11,25/09/23,7451,0,27361.23
25/09/23,Misc,3.63E+11,25/09/23,0,7152,34513.23
25/09/23,Misc,3.27E+11,25/09/23,8624,0,25889.23
25/09/23,Misc,3.63E+11,25/09/23,10000,0,15889.23
25/09/23,Misc,3.63E+11,25/09/23,2313,0,13576.23
25/09/23,Misc,3.63E+11,25/09/23,7500,0,6076.23
25/09/23,Misc,3.27E+11,25/09/23,120,0,5956.23
25/09/23,Food,3.27E+11,25/09/23,36,0,5920.23
25/09/23,Food,3.27E+11,25/09/23,40,0,5880.23
25/09/23,Misc,3.63E+11,25/09/23,275,0,5605.23
25/09/23,Misc,3.27E+11,25/09/23,329,0,5276.23
26/09/23,Food,3.27E+11,26/09/23,36,0,5240.23
26/09/23,Food,3.27E+11,26/09/23,10,0,5230.23
26/09/23,Food,3.27E+11,26/09/23,50,0,5180.23
26/09/23,Food,3.64E+11,26/09/23,159.56,0,5020.67
26/09/23,Misc,3.27E+11,26/09/23,1000,0,4020.67
27/09/23,Food,3.64E+11,27/09/23,55,0,3965.67
27/09/23,Food,3.27E+11,27/09/23,50,0,3915.67
28/09/23,Food,3.64E+11,28/09/23,100,0,3815.67
28/09/23,Food,3.27E+11,28/09/23,40,0,3775.67
28/09/23,Food,3.64E+11,28/09/23,155.5,0,3620.17
28/09/23,Misc,3.27E+11,28/09/23,240,0,3380.17
28/09/23,Misc,3.27E+11,28/09/23,247,0,3133.17
29/09/23,Food,3.27E+11,29/09/23,48,0,3085.17
29/09/23,Food,3.27E+11,29/09/23,20,0,3065.17
29/09/23,Misc,3.27E+11,29/09/23,880,0,2185.17
30/09/23,Misc,3.27E+11,30/09/23,110,0,2075.17
30/09/23,Food,3.27E+11,30/09/23,10,0,2065.17
30/09/23,Misc,3.27E+11,30/09/23,183.85,0,1881.32
30/09/23,Food,3.27E+11,30/09/23,50,0,1831.32
1/10/2023,Misc,0,30/09/23,0,20,1851.32
1/10/2023,Food,3.27E+11,1/10/2023,20,0,1831.32
1/10/2023,Food,3.27E+11,1/10/2023,20,0,1811.32
1/10/2023,Food,3.27E+11,1/10/2023,25,0,1786.32
1/10/2023,Food,3.27E+11,1/10/2023,50,0,1736.32
1/10/2023,Food,3.27E+11,1/10/2023,85,0,1651.32
2/10/2023,Food,3.27E+11,2/10/2023,10,0,1641.32
2/10/2023,Food,3.28E+11,2/10/2023,49,0,1592.32
2/10/2023,Food,3.64E+11,2/10/2023,30,0,1562.32
2/10/2023,Food,3.28E+11,2/10/2023,49,0,1513.32
2/10/2023,Food,3.28E+11,2/10/2023,80,0,1433.32
2/10/2023,Food,3.28E+11,2/10/2023,30,0,1403.32
2/10/2023,Misc,3.28E+11,2/10/2023,470,0,933.32
3/10/2023,Food,3.28E+11,3/10/2023,19,0,914.32
3/10/2023,Misc,3.28E+11,3/10/2023,130,0,784.32
3/10/2023,Food,3.64E+11,3/10/2023,188.74,0,595.58
3/10/2023,Food,3.28E+11,3/10/2023,48,0,547.58
3/10/2023,Food,3.28E+11,3/10/2023,10,0,537.58
3/10/2023,Misc,3.28E+11,3/10/2023,0,385,922.58
3/10/2023,Misc,3.28E+11,3/10/2023,680,0,242.58
3/10/2023,Misc,3.28E+11,3/10/2023,0,43,285.58
3/10/2023,Misc,3.64E+11,3/10/2023,0,1000,1285.58
3/10/2023,Misc,3.28E+11,3/10/2023,370,0,915.58
4/10/2023,Food,3.64E+11,4/10/2023,80,0,835.58
4/10/2023,Food,3.64E+11,4/10/2023,45,0,790.58
4/10/2023,Misc,3.28E+11,4/10/2023,120,0,670.58
4/10/2023,Food,3.28E+11,4/10/2023,12,0,658.58
5/10/2023,Food,3.28E+11,5/10/2023,35,0,623.58
5/10/2023,Food,3.64E+11,5/10/2023,70,0,553.58
5/10/2023,Food,3.64E+11,5/10/2023,75,0,478.58
6/10/2023,Food,3.28E+11,6/10/2023,33,0,445.58
6/10/2023,Food,3.28E+11,6/10/2023,95,0,350.58
7/10/2023,Food,3.28E+11,7/10/2023,87.69,0,262.89
7/10/2023,Misc,3.65E+11,7/10/2023,184,0,78.89
9/10/2023,Misc,3.28E+11,9/10/2023,0,1000,1078.89
9/10/2023,Food,3.28E+11,9/10/2023,79,0,999.89
10/10/2023,Food,3.28E+11,10/10/2023,50,0,949.89
10/10/2023,Food,3.65E+11,10/10/2023,42,0,907.89
11/10/2023,Food,3.65E+11,11/10/2023,80,0,827.89
12/10/2023,Food,3.65E+11,12/10/2023,70,0,757.89
13/10/23,Food,3.29E+11,13/10/23,36,0,721.89
13/10/23,Misc,3.65E+11,13/10/23,270,0,451.89
14/10/23,Food,3.29E+11,14/10/23,24,0,427.89
14/10/23,Misc,3.29E+11,14/10/23,0,270,697.89
16/10/23,Misc,3.29E+11,16/10/23,291,0,406.89
16/10/23,Misc,3.66E+11,16/10/23,0,3500,3906.89
16/10/23,Misc,3.29E+11,16/10/23,1500,0,2406.89
16/10/23,Misc,3.29E+11,16/10/23,0,286,2692.89
16/10/23,Misc,3.29E+11,16/10/23,300,0,2392.89
16/10/23,Misc,3.29E+11,16/10/23,150,0,2242.89
16/10/23,Food,3.29E+11,16/10/23,40,0,2202.89
16/10/23,Misc,3.66E+11,16/10/23,248,0,1954.89
16/10/23,Food,3.66E+11,16/10/23,30,0,1924.89
16/10/23,Food,3.66E+11,16/10/23,214.74,0,1710.15
17/10/23,Food,3.29E+11,17/10/23,65,0,1645.15
17/10/23,Misc,3.29E+11,17/10/23,706,0,939.15
17/10/23,Misc,3.29E+11,17/10/23,150,0,789.15
17/10/23,Misc,3.29E+11,17/10/23,234,0,555.15
17/10/23,Food,3.29E+11,17/10/23,60,0,495.15
18/10/23,Food,3.29E+11,18/10/23,65,0,430.15
18/10/23,Food,3.29E+11,18/10/23,10,0,420.15
19/10/23,Food,3.29E+11,19/10/23,20,0,400.15
20/10/23,Food,3.29E+11,20/10/23,18,0,382.15
20/10/23,Food,3.29E+11,20/10/23,25,0,357.15
26/10/23,Food,3.30E+11,26/10/23,100,0,257.15
26/10/23,Misc,3.30E+11,26/10/23,0,3150,3407.15
27/10/23,Misc,3.67E+11,27/10/23,3407,0,0.15
1/11/2023,Misc,3.31E+11,1/11/2023,0,500,500.15
1/11/2023,Misc,3.31E+11,1/11/2023,500,0,0.15
2/11/2023,Misc,3.31E+11,2/11/2023,0,1000,1000.15
2/11/2023,Misc,3.67E+11,2/11/2023,1000,0,0.15
2/11/2023,Misc,3.31E+11,2/11/2023,0,1000,1000.15
2/11/2023,Misc,3.67E+11,2/11/2023,1000,0,0.15
15/11/23,Misc,CHASH31948851670,15/11/23,0,33209,33209.15
15/11/23,Misc,3.69E+11,15/11/23,5000,0,28209.15
15/11/23,Misc,3.69E+11,15/11/23,3500,0,24709.15
15/11/23,Misc,3.69E+11,15/11/23,20000,0,4709.15
15/11/23,Misc,3.69E+11,15/11/23,1500,0,3209.15
17/11/23,Food,3.32E+11,17/11/23,69,0,3140.15
18/11/23,Food,3.32E+11,18/11/23,100,0,3040.15
18/11/23,Misc,3.32E+11,18/11/23,116,0,2924.15
20/11/23,Shopping,3.69E+11,20/11/23,1999,0,925.15
20/11/23,Shopping,3.69E+11,20/11/23,0,1999,2924.15
22/11/23,Misc,3.33E+11,22/11/23,150,0,2774.15
22/11/23,Misc,3.33E+11,22/11/23,150,0,2624.15
24/11/23,Salary,CHASH32649207986,24/11/23,0,24769,27393.15
24/11/23,Shopping,3.69E+11,24/11/23,499,0,26894.15
24/11/23,Misc,3.33E+11,24/11/23,1499,0,25395.15
24/11/23,Misc,3.69E+11,24/11/23,2000,0,23395.15
25/11/23,Misc,3.70E+11,25/11/23,21000,0,2395.15
26/11/23,Food,3.33E+11,26/11/23,223.18,0,2171.97
27/11/23,Misc,3.33E+11,27/11/23,0,272,2443.97
27/11/23,Misc,3.70E+11,27/11/23,720,0,1723.97
28/11/23,Misc,3.70E+11,28/11/23,480,0,1243.97
28/11/23,Misc,3.70E+11,28/11/23,250,0,993.97
30/11/23,Misc,3.70E+11,30/11/23,130,0,863.97
30/11/23,Misc,3.33E+11,30/11/23,0,50,913.97
1/12/2023,Food,3.70E+11,2/12/2023,19,0,894.97
2/12/2023,Misc,3.34E+11,2/12/2023,200,0,694.97
3/12/2023,Misc,3.34E+11,3/12/2023,120,0,574.97
3/12/2023,Misc,3.34E+11,3/12/2023,0,7,581.97
3/12/2023,Misc,3.34E+11,3/12/2023,0,70,651.97
4/12/2023,Misc,3.34E+11,4/12/2023,500,0,151.97
4/12/2023,Misc,3.34E+11,4/12/2023,0,500,651.97
4/12/2023,Misc,3.34E+11,4/12/2023,450,0,201.97
6/12/2023,Misc,3.71E+11,6/12/2023,0,150,351.97
6/12/2023,Food,3.71E+11,6/12/2023,60,0,291.97
7/12/2023,Misc,3.34E+11,8/12/2023,0,15000,15291.97
9/12/2023,Misc,3.34E+11,9/12/2023,15048,0,243.97
10/12/2023,Misc,3.71E+11,10/12/2023,0,4000,4243.97
10/12/2023,Transport,3.34E+11,10/12/2023,3062,0,1181.97
10/12/2023,Misc,3.71E+11,10/12/2023,1000,0,181.97
10/12/2023,Misc,3.34E+11,10/12/2023,0,1000,1181.97
11/12/2023,Food,3.71E+11,11/12/2023,30,0,1151.97
11/12/2023,Food,3.71E+11,11/12/2023,10,0,1141.97
11/12/2023,Food,3.71E+11,11/12/2023,30,0,1111.97
11/12/2023,Misc,3.71E+11,11/12/2023,220,0,891.97
11/12/2023,Food,3.35E+11,11/12/2023,169.29,0,722.68
12/12/2023,Food,3.71E+11,12/12/2023,25,0,697.68
12/12/2023,Food,3.71E+11,12/12/2023,40,0,657.68
12/12/2023,Food,3.71E+11,12/12/2023,20,0,637.68
12/12/2023,Misc,3.35E+11,12/12/2023,530,0,107.68
12/12/2023,Food,3.71E+11,12/12/2023,35,0,72.68
12/12/2023,Misc,3.35E+11,12/12/2023,0,1718,1790.68
12/12/2023,Transport,3.35E+11,12/12/2023,1718,0,72.68
13/12/23,Food,3.71E+11,13/12/23,26,0,46.68
13/12/23,Food,3.71E+11,13/12/23,15,0,31.68
13/12/23,Transport,3.35E+11,13/12/23,0,1718,1749.68
13/12/23,Misc,3.71E+11,13/12/23,1718,0,31.68
1/1/2024,Misc,0,31/12/23,0,8,39.68
